Day,Symptoms & Abnormal Findings,Heart / Circulatory,Injury / Physical harm,Digestive,Respiratory,Mental Health,Total Patients
1/1/2019,4,5,3,1,2,3,18
1/2/2019,11,6,1,2,4,3,27
1/3/2019,6,7,6,4,1,1,25
1/4/2019,15,10,1,6,5,2,39
1/5/2019,13,4,6,1,2,1,27
1/6/2019,10,8,3,6,1,2,30
1/7/2019,7,4,2,5,2,3,23
1/8/2019,8,5,3,0,1,1,18
1/9/2019,15,10,4,4,7,2,42
1/10/2019,12,11,1,6,1,0,31
1/11/2019,23,15,7,1,6,1,53
1/12/2019,20,8,2,4,6,3,43
1/13/2019,9,7,4,3,1,2,26
1/14/2019,7,5,5,3,4,1,25
1/15/2019,11,10,1,3,3,4,32
1/16/2019,14,10,4,1,4,3,36
1/17/2019,9,5,3,7,1,1,26
1/18/2019,5,4,3,5,0,0,17
1/19/2019,7,3,1,2,1,0,14
1/20/2019,7,4,5,2,0,1,19
1/21/2019,3,5,5,0,2,1,16
1/22/2019,2,3,0,0,1,0,6
1/23/2019,12,6,0,4,4,1,27
1/24/2019,13,6,4,1,4,3,31
1/25/2019,14,8,7,1,3,1,34
1/26/2019,9,8,3,5,3,1,29
1/27/2019,2,2,4,0,3,3,14
1/28/2019,5,2,1,4,0,1,13
1/29/2019,7,3,3,2,0,1,16
1/30/2019,5,3,4,1,4,1,18
1/31/2019,5,3,0,1,2,2,13
2/1/2019,10,6,2,4,2,3,27
2/2/2019,8,4,1,5,3,2,23
2/3/2019,7,0,1,0,2,2,12
2/4/2019,5,1,2,2,0,1,11
2/5/2019,7,4,3,1,3,1,19
2/6/2019,3,4,6,3,0,1,17
2/7/2019,5,4,5,1,3,1,19
2/8/2019,8,4,2,5,3,4,26
2/9/2019,17,8,1,4,2,2,34
2/10/2019,7,3,1,2,0,0,13
2/11/2019,7,5,2,3,2,3,22
2/12/2019,11,5,5,1,1,2,25
2/13/2019,16,8,1,1,5,0,31
2/14/2019,9,8,1,1,2,0,21
2/15/2019,8,3,2,5,1,2,21
2/16/2019,13,9,5,0,2,4,33
2/17/2019,5,2,4,1,3,2,17
2/18/2019,6,2,1,2,2,2,15
2/19/2019,10,3,3,2,2,1,21
2/20/2019,13,3,7,4,4,2,33
2/21/2019,8,6,5,6,1,1,27
2/22/2019,4,4,1,0,2,0,11
2/23/2019,7,3,0,4,2,0,16
2/24/2019,13,5,1,4,3,0,26
2/25/2019,5,1,3,3,1,1,14
2/26/2019,8,5,3,6,2,1,25
2/27/2019,9,4,1,3,2,3,22
2/28/2019,12,8,2,3,7,1,33
3/1/2019,10,9,1,5,3,1,29
3/2/2019,6,4,2,0,1,3,16
3/3/2019,8,8,3,2,3,2,26
3/4/2019,3,2,2,1,0,1,9
3/5/2019,4,1,5,3,1,1,15
3/6/2019,8,2,1,1,0,0,12
3/7/2019,9,7,4,1,5,2,28
3/8/2019,10,5,1,1,1,0,18
3/9/2019,3,3,1,2,0,1,10
3/10/2019,15,10,3,1,0,2,31
3/11/2019,5,6,4,2,2,1,20
3/12/2019,4,4,5,3,1,1,18
3/13/2019,10,5,6,2,0,2,25
3/14/2019,10,8,4,4,5,3,34
3/15/2019,5,3,2,1,0,2,13
3/16/2019,4,1,3,2,1,2,13
3/17/2019,8,8,5,1,1,2,25
3/18/2019,6,2,4,0,1,2,15
3/19/2019,5,2,5,0,1,3,16
3/20/2019,8,2,2,2,1,1,16
3/21/2019,7,5,2,1,3,2,20
3/22/2019,8,5,4,1,3,1,22
3/23/2019,12,8,4,2,4,4,34
3/24/2019,4,5,2,0,4,1,16
3/25/2019,2,2,2,1,1,0,8
3/26/2019,8,1,4,4,0,2,19
3/27/2019,10,2,2,2,3,1,20
3/28/2019,13,6,3,4,1,3,30
3/29/2019,6,2,4,3,3,1,19
3/30/2019,7,4,2,4,0,0,17
3/31/2019,3,1,0,0,2,3,9
4/1/2019,5,4,4,4,3,0,20
4/2/2019,3,5,1,0,2,0,11
4/3/2019,6,4,2,2,2,1,17
4/4/2019,5,2,3,4,0,1,15
4/5/2019,8,4,5,2,4,3,26
4/6/2019,7,2,1,3,0,1,14
4/7/2019,4,5,1,5,4,2,21
4/8/2019,7,2,1,5,0,0,15
4/9/2019,9,5,7,2,0,3,26
4/10/2019,9,7,3,5,5,1,30
4/11/2019,11,5,4,2,3,1,26
4/12/2019,6,8,4,2,8,1,29
4/13/2019,5,5,1,3,4,1,19
4/14/2019,5,4,3,5,2,2,21
4/15/2019,15,5,5,4,5,0,34
4/16/2019,2,4,1,1,4,2,14
4/17/2019,4,4,1,4,1,3,17
4/18/2019,12,10,6,7,4,5,44
4/19/2019,6,4,2,0,2,1,15
4/20/2019,10,6,1,3,4,4,28
4/21/2019,13,6,3,5,2,2,31
4/22/2019,3,3,2,3,3,1,15
4/23/2019,3,2,1,3,1,0,10
4/24/2019,6,6,3,6,2,0,23
4/25/2019,5,2,2,2,0,0,11
4/26/2019,7,6,3,6,3,1,26
4/27/2019,5,8,2,2,2,0,19
4/28/2019,7,5,2,7,2,1,24
4/29/2019,6,4,2,2,3,1,18
4/30/2019,4,3,3,3,0,1,14
5/1/2019,11,5,9,2,5,2,34
5/2/2019,17,7,5,2,2,0,33
5/3/2019,8,3,3,0,3,0,17
5/4/2019,4,1,1,2,1,0,9
5/5/2019,6,6,6,1,2,1,22
5/6/2019,9,1,3,3,4,0,20
5/7/2019,8,1,6,3,6,2,26
5/8/2019,12,11,5,4,5,1,38
5/9/2019,2,2,1,2,2,0,9
5/10/2019,7,3,2,2,0,1,15
5/11/2019,10,6,4,0,2,4,26
5/12/2019,5,5,3,0,1,0,14
5/13/2019,9,3,6,4,2,1,25
5/14/2019,4,3,2,3,4,1,17
5/15/2019,9,4,4,3,3,2,25
5/16/2019,8,2,2,2,1,2,17
5/17/2019,6,8,4,3,1,1,23
5/18/2019,7,5,3,1,4,2,22
5/19/2019,14,7,1,4,3,2,31
5/20/2019,8,4,2,3,2,0,19
5/21/2019,7,6,3,2,2,0,20
5/22/2019,4,1,4,1,0,1,11
5/23/2019,6,1,4,3,4,1,19
5/24/2019,5,2,4,0,2,0,13
5/25/2019,5,3,6,2,2,3,21
5/26/2019,3,4,2,2,1,0,12
5/27/2019,2,1,3,0,0,1,7
5/28/2019,3,3,5,0,0,1,12
5/29/2019,9,2,4,4,4,2,25
5/30/2019,12,4,8,4,2,2,32
5/31/2019,5,3,5,2,0,2,17
6/1/2019,9,6,3,4,3,2,27
6/2/2019,6,5,4,3,3,1,22
6/3/2019,5,7,3,6,1,1,23
6/4/2019,11,2,4,4,1,1,23
6/5/2019,13,5,6,2,0,3,29
6/6/2019,12,8,5,1,0,4,30
6/7/2019,7,2,4,2,2,1,18
6/8/2019,8,4,3,1,1,1,18
6/9/2019,7,2,3,3,1,4,20
6/10/2019,2,2,2,2,0,1,9
6/11/2019,12,5,3,3,3,1,27
6/12/2019,3,3,0,2,1,1,10
6/13/2019,9,2,2,2,2,0,17
6/14/2019,3,2,2,2,1,1,11
6/15/2019,3,4,2,1,2,2,14
6/16/2019,6,3,3,2,1,2,17
6/17/2019,7,4,3,5,2,0,21
6/18/2019,7,0,5,1,0,0,13
6/19/2019,5,4,3,3,4,0,19
6/20/2019,3,5,1,3,3,1,16
6/21/2019,4,4,2,3,3,1,17
6/22/2019,6,7,3,2,2,2,22
6/23/2019,5,1,5,0,1,1,13
6/24/2019,6,2,2,1,1,1,13
6/25/2019,2,0,2,2,0,2,8
6/26/2019,10,3,7,4,1,2,27
6/27/2019,7,6,6,1,5,1,26
6/28/2019,6,3,4,2,1,1,17
6/29/2019,13,8,5,4,3,0,33
6/30/2019,7,5,1,4,3,1,21
7/1/2019,8,7,3,3,2,2,25
7/2/2019,3,4,5,2,4,1,19
7/3/2019,4,4,4,1,1,3,17
7/4/2019,10,3,4,1,1,1,20
7/5/2019,7,2,2,2,2,4,19
7/6/2019,10,3,1,2,0,4,20
7/7/2019,13,4,2,1,4,4,28
7/8/2019,9,11,5,3,4,0,32
7/9/2019,9,4,4,3,3,5,28
7/10/2019,8,4,5,7,3,0,27
7/11/2019,4,2,3,1,1,0,11
7/12/2019,13,5,3,3,1,1,26
7/13/2019,14,9,6,3,2,0,34
7/14/2019,10,7,2,6,2,0,27
7/15/2019,3,3,6,2,0,2,16
7/16/2019,4,4,2,3,2,0,15
7/17/2019,9,5,5,2,2,3,26
7/18/2019,9,6,5,3,0,1,24
7/19/2019,6,4,5,4,0,2,21
7/20/2019,6,3,1,0,0,1,11
7/21/2019,10,4,8,3,0,0,25
7/22/2019,1,0,0,0,0,1,2
7/23/2019,4,4,3,4,2,1,18
7/24/2019,9,5,2,4,0,2,22
7/25/2019,10,4,8,6,1,1,30
7/26/2019,6,4,1,1,2,3,17
7/27/2019,18,8,7,2,1,2,38
7/28/2019,10,8,3,5,3,1,30
7/29/2019,8,3,4,1,1,1,18
7/30/2019,8,2,4,0,1,1,16
7/31/2019,7,3,3,4,3,2,22
8/1/2019,17,12,12,7,3,1,52
8/2/2019,15,5,6,1,3,0,30
8/3/2019,13,4,4,1,1,1,24
8/4/2019,16,7,7,1,2,1,34
8/5/2019,5,2,3,3,1,2,16
8/6/2019,14,8,6,2,3,3,36
8/7/2019,11,5,4,4,3,1,28
8/8/2019,16,9,4,6,4,1,40
8/9/2019,9,4,5,3,0,3,24
8/10/2019,6,3,3,1,0,2,15
8/11/2019,6,4,6,2,0,2,20
8/12/2019,6,4,2,3,1,1,17
8/13/2019,6,5,3,2,1,3,20
8/14/2019,14,8,7,2,2,2,35
8/15/2019,23,11,7,9,4,3,57
8/16/2019,6,1,3,1,0,2,13
8/17/2019,10,6,9,3,3,1,32
8/18/2019,18,10,6,1,2,5,42
8/19/2019,10,7,5,2,2,3,29
8/20/2019,10,3,8,2,2,1,26
8/21/2019,23,16,4,8,9,6,66
8/22/2019,15,11,10,6,3,2,47
8/23/2019,5,3,4,2,1,0,15
8/24/2019,27,14,7,2,3,5,58
8/25/2019,15,7,6,9,1,1,39
8/26/2019,11,2,4,2,2,2,23
8/27/2019,6,4,2,1,2,2,17
8/28/2019,22,13,7,5,4,1,52
8/29/2019,15,4,14,1,3,3,40
8/30/2019,13,4,10,4,2,3,36
8/31/2019,18,11,8,1,6,3,47
9/1/2019,14,6,4,5,2,4,35
9/2/2019,9,6,7,2,0,1,25
9/3/2019,9,4,4,3,3,6,29
9/4/2019,15,5,2,3,0,0,25
9/5/2019,20,13,8,3,4,7,55
9/6/2019,12,3,6,3,3,1,28
9/7/2019,12,4,2,5,4,1,28
9/8/2019,5,5,2,2,2,1,17
9/9/2019,3,1,3,5,0,2,14
9/10/2019,8,2,3,2,0,1,16
9/11/2019,5,2,3,2,3,1,16
9/12/2019,9,4,2,4,3,2,24
9/13/2019,6,2,2,2,3,2,17
9/14/2019,7,5,4,3,1,1,21
9/15/2019,7,2,2,3,0,2,16
9/16/2019,9,3,2,6,3,3,26
9/17/2019,5,3,6,1,2,0,17
9/18/2019,10,4,7,2,2,3,28
9/19/2019,8,8,2,3,0,1,22
9/20/2019,6,2,2,3,2,1,16
9/21/2019,6,4,2,2,2,0,16
9/22/2019,11,5,1,2,2,0,21
9/23/2019,12,3,4,2,1,2,24
9/24/2019,11,5,4,3,2,3,28
9/25/2019,11,12,3,2,6,2,36
9/26/2019,11,5,4,3,4,1,28
9/27/2019,16,10,9,2,3,3,43
9/28/2019,5,4,1,1,1,1,13
9/29/2019,8,3,3,1,4,0,19
9/30/2019,9,5,1,5,3,1,24
10/1/2019,10,5,6,3,3,2,29
10/2/2019,9,2,6,1,1,4,23
10/3/2019,8,6,4,3,0,2,23
10/4/2019,9,4,1,0,1,2,17
10/5/2019,11,3,3,1,0,2,20
10/6/2019,4,2,5,1,1,2,15
10/7/2019,7,4,3,2,4,1,21
10/8/2019,5,2,4,2,0,1,14
10/9/2019,6,3,0,1,4,1,15
10/10/2019,12,5,7,5,3,4,36
10/11/2019,7,7,2,4,1,1,22
10/12/2019,8,6,4,2,2,1,23
10/13/2019,12,4,1,3,2,5,27
10/14/2019,2,2,4,1,3,2,14
10/15/2019,4,3,5,0,0,1,13
10/16/2019,8,8,4,4,3,1,28
10/17/2019,9,6,4,3,0,1,23
10/18/2019,9,4,2,4,2,3,24
10/19/2019,8,10,3,1,3,3,28
10/20/2019,11,3,6,4,4,1,29
10/21/2019,9,3,3,2,4,1,22
10/22/2019,6,2,4,2,2,2,18
10/23/2019,12,7,7,3,2,4,35
10/24/2019,2,1,3,5,0,0,11
10/25/2019,10,7,5,0,4,1,27
10/26/2019,9,3,4,3,2,1,22
10/27/2019,6,7,5,0,1,2,21
10/28/2019,6,5,4,3,4,1,23
10/29/2019,5,3,4,0,2,2,16
10/30/2019,11,4,7,4,0,1,27
10/31/2019,5,2,1,0,2,0,10
11/1/2019,6,4,2,1,0,0,13
11/2/2019,8,9,5,2,2,1,27
11/3/2019,5,3,2,0,0,3,13
11/4/2019,11,5,6,1,1,0,24
11/5/2019,6,5,2,2,4,0,19
11/6/2019,7,5,4,1,1,0,18
11/7/2019,11,9,2,4,7,3,36
11/8/2019,12,4,1,3,4,2,26
11/9/2019,6,2,2,2,1,1,14
11/10/2019,7,3,3,3,0,0,16
11/11/2019,5,2,1,2,0,1,11
11/12/2019,6,2,5,0,2,2,17
11/13/2019,8,2,2,1,4,2,19
11/14/2019,8,8,6,2,5,0,29
11/15/2019,6,4,4,2,2,3,21
11/16/2019,6,2,2,2,2,1,15
11/17/2019,5,4,3,1,2,0,15
11/18/2019,4,7,3,1,2,2,19
11/19/2019,8,6,2,2,4,1,23
11/20/2019,5,3,3,1,1,0,13
11/21/2019,12,4,8,2,1,3,30
11/22/2019,4,2,2,3,1,2,14
11/23/2019,5,1,3,0,2,1,12
11/24/2019,1,0,3,0,1,0,5
11/25/2019,11,5,5,1,4,1,27
11/26/2019,19,7,2,2,2,3,35
11/27/2019,9,3,9,2,4,2,29
11/28/2019,10,6,6,0,2,2,26
11/29/2019,7,3,1,2,5,0,18
11/30/2019,3,4,1,1,1,1,11
12/1/2019,3,4,0,1,2,2,12
12/2/2019,5,1,2,1,1,3,13
12/3/2019,5,3,1,2,1,0,12
12/4/2019,4,2,1,1,2,0,10
12/5/2019,9,7,2,3,3,0,24
12/6/2019,5,4,1,1,1,0,12
12/7/2019,10,8,2,4,1,2,27
12/8/2019,7,1,2,1,1,1,13
12/9/2019,5,1,1,3,1,1,12
12/10/2019,4,2,2,1,3,2,14
12/11/2019,11,4,4,5,3,1,28
12/12/2019,8,7,5,5,5,1,31
12/13/2019,6,8,2,4,0,1,21
12/14/2019,9,5,5,4,1,1,25
12/15/2019,9,5,6,3,4,1,28
12/16/2019,5,2,1,1,2,1,12
12/17/2019,6,7,2,3,2,1,21
12/18/2019,5,8,3,4,3,0,23
12/19/2019,10,5,4,1,4,1,25
12/20/2019,12,7,2,4,3,0,28
12/21/2019,3,3,1,1,1,0,9
12/22/2019,7,4,1,4,1,5,22
12/23/2019,9,5,1,1,2,3,21
12/24/2019,9,6,2,4,7,1,29
12/25/2019,6,2,3,1,1,1,14
12/26/2019,11,11,2,1,7,3,35
12/27/2019,8,2,2,3,1,1,17
12/28/2019,12,8,3,4,4,4,35
12/29/2019,14,11,6,4,3,2,40
12/30/2019,4,3,3,2,3,0,15
12/31/2019,16,8,2,6,5,2,39
1/1/2020,8,9,3,1,6,3,30
1/2/2020,6,6,3,1,2,0,18
1/3/2020,5,8,2,0,2,0,17
1/4/2020,8,7,2,0,2,1,20
1/5/2020,9,7,4,1,3,2,26
1/6/2020,9,4,4,3,8,2,30
1/7/2020,5,6,2,0,0,2,15
1/8/2020,6,3,3,1,1,4,18
1/9/2020,5,5,1,2,2,1,16
1/10/2020,4,3,2,2,1,0,12
1/11/2020,4,4,5,2,2,0,17
1/12/2020,15,7,3,1,5,2,33
1/13/2020,7,5,4,2,0,3,21
1/14/2020,5,2,1,2,1,1,12
1/15/2020,8,4,1,2,1,1,17
1/16/2020,6,6,2,1,1,1,17
1/17/2020,2,2,3,0,0,1,8
1/18/2020,12,7,3,1,3,1,27
1/19/2020,9,6,2,2,2,3,24
1/20/2020,6,5,3,1,4,3,22
1/21/2020,6,6,4,1,1,0,18
1/22/2020,6,3,2,0,3,0,14
1/23/2020,7,4,0,4,2,0,17
1/24/2020,9,6,3,2,2,2,24
1/25/2020,5,6,1,3,0,2,17
1/26/2020,18,7,7,5,2,2,41
1/27/2020,10,11,1,4,2,4,32
1/28/2020,3,6,0,1,3,1,14
1/29/2020,7,6,2,2,3,1,21
1/30/2020,4,2,2,0,0,3,11
1/31/2020,5,6,2,1,1,3,18
2/1/2020,4,5,4,1,1,1,16
2/2/2020,7,9,3,2,2,1,24
2/3/2020,5,3,1,1,4,2,16
2/4/2020,5,3,1,2,3,0,14
2/5/2020,5,3,0,1,1,2,12
2/6/2020,6,1,1,1,1,1,11
2/7/2020,7,6,3,2,2,1,21
2/8/2020,13,7,4,2,3,3,32
2/9/2020,7,2,4,0,2,3,18
2/10/2020,4,0,1,0,0,1,6
2/11/2020,6,6,1,0,1,1,15
2/12/2020,4,1,2,2,0,3,12
2/13/2020,3,3,3,0,1,2,12
2/14/2020,7,1,3,4,1,2,18
2/15/2020,14,10,4,3,5,6,42
2/16/2020,6,2,4,0,1,2,15
2/17/2020,7,5,1,1,3,2,19
2/18/2020,9,5,3,2,2,2,23
2/19/2020,8,3,5,1,5,1,23
2/20/2020,6,4,3,4,3,2,22
2/21/2020,14,10,8,3,3,4,42
2/22/2020,6,5,1,1,0,0,13
2/23/2020,7,3,5,2,0,3,20
2/24/2020,7,8,1,1,1,1,19
2/25/2020,11,9,2,1,1,2,26
2/26/2020,3,4,3,2,3,0,15
2/27/2020,1,0,1,2,0,0,4
2/28/2020,11,5,4,5,2,0,27
3/1/2020,7,7,2,1,5,5,27
3/2/2020,11,7,1,3,0,4,26
3/3/2020,3,4,1,3,1,2,14
3/4/2020,7,6,3,3,1,3,23
3/5/2020,6,7,2,2,0,0,17
3/6/2020,6,6,3,1,2,2,20
3/7/2020,11,11,4,1,3,2,32
3/8/2020,3,2,3,1,0,1,10
3/9/2020,11,4,4,3,0,0,22
3/10/2020,5,3,0,0,2,1,11
3/11/2020,5,4,4,0,3,0,16
3/12/2020,2,2,3,1,1,1,10
3/13/2020,8,4,5,3,1,2,23
3/14/2020,6,5,1,3,0,1,16
3/15/2020,8,4,2,2,3,3,22
3/16/2020,9,3,1,2,3,3,21
3/17/2020,7,6,2,1,2,4,22
3/18/2020,4,6,2,2,2,0,16
3/19/2020,9,5,4,3,2,2,25
3/20/2020,9,5,4,2,1,1,22
3/21/2020,12,8,1,2,5,0,28
3/22/2020,12,4,1,1,5,3,26
3/23/2020,11,7,5,0,2,4,29
3/24/2020,15,11,5,3,6,1,41
3/25/2020,5,2,3,1,0,3,14
3/26/2020,7,5,5,0,3,2,22
3/27/2020,7,5,2,1,3,1,19
3/28/2020,7,5,7,0,2,2,23
3/29/2020,6,4,1,2,1,1,15
3/30/2020,14,8,1,1,0,1,25
3/31/2020,10,9,6,2,1,4,32
4/1/2020,11,8,3,2,4,1,29
4/2/2020,7,9,3,1,1,2,23
4/3/2020,2,2,2,1,1,0,8
4/4/2020,14,11,0,3,5,1,34
4/5/2020,8,4,0,3,6,2,23
4/6/2020,11,9,1,1,4,3,29
4/7/2020,15,6,3,3,3,1,31
4/8/2020,10,6,2,0,1,2,21
4/9/2020,5,2,3,0,1,0,11
4/10/2020,4,2,0,4,1,0,11
4/11/2020,9,5,5,2,4,1,26
4/12/2020,5,4,1,1,2,1,14
4/13/2020,7,3,1,2,1,2,16
4/14/2020,12,7,5,3,1,4,32
4/15/2020,4,5,2,1,2,2,16
4/16/2020,12,10,1,7,2,4,36
4/17/2020,8,4,4,1,6,1,24
4/18/2020,9,6,2,3,2,1,23
4/19/2020,13,7,1,4,0,1,26
4/20/2020,9,10,0,7,3,0,29
4/21/2020,4,4,1,2,0,1,12
4/22/2020,6,4,3,4,3,1,21
4/23/2020,5,3,4,1,3,0,16
4/24/2020,6,2,2,2,0,2,14
4/25/2020,13,12,5,5,2,1,38
4/26/2020,15,6,7,1,4,3,36
4/27/2020,10,10,6,3,3,1,33
4/28/2020,7,6,0,0,3,0,16
4/29/2020,5,4,2,4,1,1,17
4/30/2020,3,2,8,2,0,1,16
5/1/2020,3,3,1,1,3,1,12
5/2/2020,7,6,2,3,6,1,25
5/3/2020,7,2,2,2,1,4,18
5/4/2020,7,4,3,1,1,2,18
5/5/2020,11,4,3,2,3,2,25
5/6/2020,5,5,2,0,2,1,15
5/7/2020,5,5,5,2,3,2,22
5/8/2020,10,5,2,0,3,1,21
5/9/2020,15,5,6,2,0,3,31
5/10/2020,7,3,3,5,2,1,21
5/11/2020,3,2,0,2,0,0,7
5/12/2020,7,5,3,2,3,2,22
5/13/2020,3,5,5,0,3,2,18
5/14/2020,6,5,3,0,3,2,19
5/15/2020,5,3,4,2,3,3,20
5/16/2020,13,7,1,1,1,3,26
5/17/2020,9,4,1,3,4,2,23
5/18/2020,4,1,0,0,1,3,9
5/19/2020,9,7,1,2,3,1,23
5/20/2020,6,8,3,2,3,3,25
5/21/2020,8,5,6,1,2,3,25
5/22/2020,8,2,6,3,1,4,24
5/23/2020,10,10,3,2,5,3,33
5/24/2020,6,4,2,1,0,2,15
5/25/2020,5,2,6,1,0,2,16
5/26/2020,6,2,3,1,2,2,16
5/27/2020,6,4,4,1,1,2,18
5/28/2020,5,5,6,2,2,1,21
5/29/2020,2,1,2,2,1,0,8
5/30/2020,9,4,4,0,1,1,19
5/31/2020,10,8,6,4,2,1,31
6/1/2020,4,3,1,0,0,3,11
6/2/2020,17,6,5,6,3,5,42
6/3/2020,6,0,4,2,2,0,14
6/4/2020,3,2,0,4,1,0,10
6/5/2020,4,2,2,2,2,1,13
6/6/2020,15,9,1,4,2,1,32
6/7/2020,9,7,6,1,5,2,30
6/8/2020,12,8,3,2,3,1,29
6/9/2020,6,9,1,4,2,3,25
6/10/2020,3,5,4,1,0,1,14
6/11/2020,4,0,2,0,0,0,6
6/12/2020,2,1,2,2,1,1,9
6/13/2020,9,4,4,0,0,1,18
6/14/2020,9,7,2,4,3,0,25
6/15/2020,4,1,3,2,1,2,13
6/16/2020,3,1,2,2,1,1,10
6/17/2020,5,3,1,2,1,0,12
6/18/2020,13,7,2,2,5,1,30
6/19/2020,11,4,3,3,3,1,25
6/20/2020,10,8,2,2,2,3,27
6/21/2020,6,3,3,0,2,3,17
6/22/2020,6,3,2,1,2,1,15
6/23/2020,9,3,3,2,0,1,18
6/24/2020,10,8,8,4,3,4,37
6/25/2020,10,4,1,5,1,1,22
6/26/2020,1,2,0,2,3,1,9
6/27/2020,6,5,6,1,2,4,24
6/28/2020,8,3,2,4,2,4,23
6/29/2020,7,3,0,2,1,4,17
6/30/2020,4,5,2,2,2,2,17
7/1/2020,5,2,4,2,0,1,14
7/2/2020,6,5,5,3,0,1,20
7/3/2020,9,4,2,4,1,4,24
7/4/2020,3,0,2,2,2,0,9
7/5/2020,11,9,2,3,3,0,28
7/6/2020,10,6,4,3,5,1,29
7/7/2020,7,4,2,2,2,1,18
7/8/2020,8,7,3,0,1,1,20
7/9/2020,0,1,2,2,1,0,6
7/10/2020,7,3,2,0,2,1,15
7/11/2020,5,12,3,1,2,1,24
7/12/2020,10,3,3,3,0,3,22
7/13/2020,5,6,4,4,1,3,23
7/14/2020,6,5,1,2,2,0,16
7/15/2020,5,0,3,2,0,2,12
7/16/2020,12,3,4,1,1,2,23
7/17/2020,7,2,7,3,2,1,22
7/18/2020,9,7,4,1,2,5,28
7/19/2020,11,7,6,3,0,2,29
7/20/2020,8,4,2,1,2,2,19
7/21/2020,5,2,3,4,2,1,17
7/22/2020,4,4,1,2,4,0,15
7/23/2020,7,5,3,2,2,3,22
7/24/2020,5,4,6,2,0,2,19
7/25/2020,8,3,6,2,0,1,20
7/26/2020,2,2,5,4,2,0,15
7/27/2020,2,3,2,4,2,2,15
7/28/2020,6,3,4,1,1,2,17
7/29/2020,6,8,6,4,3,1,28
7/30/2020,3,1,4,1,1,0,10
7/31/2020,3,3,2,0,3,0,11
8/1/2020,9,4,1,2,2,1,19
8/2/2020,8,3,0,1,0,0,12
8/3/2020,7,4,3,0,2,1,17
8/4/2020,11,5,3,5,3,0,27
8/5/2020,9,5,6,1,3,3,27
8/6/2020,3,1,3,5,0,3,15
8/7/2020,7,1,6,0,2,2,18
8/8/2020,6,6,1,0,1,3,17
8/9/2020,11,9,3,2,0,0,25
8/10/2020,7,4,1,1,1,0,14
8/11/2020,2,2,0,2,3,1,10
8/12/2020,9,6,2,3,4,1,25
8/13/2020,6,5,2,2,0,4,19
8/14/2020,5,2,1,2,3,1,14
8/15/2020,9,3,3,1,1,3,20
8/16/2020,8,5,4,0,2,0,19
8/17/2020,11,8,3,4,2,2,30
8/18/2020,7,4,4,3,1,0,19
8/19/2020,4,0,2,1,1,3,11
8/20/2020,8,5,5,2,1,3,24
8/21/2020,12,3,5,4,0,2,26
8/22/2020,10,3,5,1,2,1,22
8/23/2020,7,4,4,1,1,1,18
8/24/2020,6,1,2,2,1,1,13
8/25/2020,12,6,4,2,1,0,25
8/26/2020,8,5,3,3,3,2,24
8/27/2020,6,4,4,1,1,4,20
8/28/2020,7,6,6,2,1,4,26
8/29/2020,7,2,4,6,1,2,22
8/30/2020,11,7,5,1,0,0,24
8/31/2020,4,2,3,1,1,0,11
9/1/2020,6,5,4,1,0,1,17
9/2/2020,8,2,2,4,1,2,19
9/3/2020,6,3,5,1,1,2,18
9/4/2020,9,4,10,2,3,2,30
9/5/2020,7,5,4,1,0,2,19
9/6/2020,14,4,3,2,5,2,30
9/7/2020,15,4,2,2,2,4,29
9/8/2020,13,4,6,4,6,4,37
9/9/2020,5,4,4,0,1,2,16
9/10/2020,7,3,2,3,3,3,21
9/11/2020,9,2,4,2,3,2,22
9/12/2020,10,4,3,2,4,4,27
9/13/2020,6,2,4,0,1,3,16
9/14/2020,9,3,3,4,1,2,22
9/15/2020,14,6,5,4,3,5,37
9/16/2020,12,4,4,3,0,3,26
9/17/2020,5,2,2,2,1,1,13
9/18/2020,8,3,3,4,2,1,21
9/19/2020,7,5,5,1,2,1,21
9/20/2020,5,3,4,1,5,2,20
9/21/2020,8,6,7,5,2,1,29
9/22/2020,5,5,2,0,5,2,19
9/23/2020,8,7,3,2,2,2,24
9/24/2020,7,6,7,2,3,2,27
9/25/2020,9,8,8,3,6,0,34
9/26/2020,8,6,1,2,2,0,19
9/27/2020,11,7,0,1,2,5,26
9/28/2020,7,4,3,3,0,2,19
9/29/2020,8,3,1,2,2,1,17
9/30/2020,11,3,5,2,1,3,25
10/1/2020,4,3,3,3,1,1,15
10/2/2020,6,2,4,0,1,2,15
10/3/2020,6,2,1,3,0,2,14
10/4/2020,5,3,1,2,2,2,15
10/5/2020,11,5,5,2,3,3,29
10/6/2020,5,5,3,4,1,1,19
10/7/2020,14,8,1,5,2,2,32
10/8/2020,5,4,4,3,0,3,19
10/9/2020,5,0,2,2,1,3,13
10/10/2020,14,8,1,3,3,1,30
10/11/2020,6,4,1,1,1,0,13
10/12/2020,4,1,4,2,0,1,12
10/13/2020,7,5,3,3,1,1,20
10/14/2020,3,2,4,0,1,1,11
10/15/2020,3,2,2,0,1,1,9
10/16/2020,3,2,0,1,2,1,9
10/17/2020,8,3,1,2,0,2,16
10/18/2020,5,2,3,1,1,4,16
10/19/2020,8,7,2,1,3,0,21
10/20/2020,8,3,5,1,2,1,20
10/21/2020,6,2,3,1,2,0,14
10/22/2020,4,0,1,1,0,0,6
10/23/2020,3,1,2,0,1,1,8
10/24/2020,5,2,2,1,2,0,12
10/25/2020,6,4,5,0,2,3,20
10/26/2020,12,4,3,3,2,2,26
10/27/2020,7,7,1,1,1,5,22
10/28/2020,4,3,1,1,0,1,10
10/29/2020,3,1,5,0,1,1,11
10/30/2020,3,2,1,1,1,1,9
10/31/2020,8,4,5,1,3,2,23
11/1/2020,4,6,5,2,2,1,20
11/2/2020,8,3,4,3,6,3,27
11/3/2020,13,11,8,6,4,1,43
11/4/2020,7,5,1,4,3,1,21
11/5/2020,9,4,4,2,3,2,24
11/6/2020,6,5,1,1,3,1,17
11/7/2020,13,7,4,2,3,2,31
11/8/2020,9,4,3,2,1,1,20
11/9/2020,8,3,3,1,3,1,19
11/10/2020,8,5,2,2,1,3,21
11/11/2020,13,11,5,5,3,3,40
11/12/2020,6,1,3,1,4,3,18
11/13/2020,9,6,6,1,2,3,27
11/14/2020,8,5,4,2,4,2,25
11/15/2020,6,6,5,1,2,0,20
11/16/2020,5,4,2,1,0,2,14
11/17/2020,10,6,1,2,0,1,20
11/18/2020,2,1,0,4,1,0,8
11/19/2020,7,4,0,3,3,1,18
11/20/2020,6,4,3,1,6,1,21
11/21/2020,6,3,1,2,3,0,15
11/22/2020,7,6,3,2,6,4,28
11/23/2020,1,3,3,1,2,2,12
11/24/2020,8,2,1,3,5,1,20
11/25/2020,6,1,3,2,4,5,21
11/26/2020,10,4,4,1,4,3,26
11/27/2020,6,4,3,2,7,0,22
11/28/2020,14,4,3,1,10,0,32
11/29/2020,12,5,9,3,8,3,40
11/30/2020,7,4,3,2,7,0,23
12/1/2020,8,3,2,2,2,0,17
12/2/2020,15,9,3,1,5,2,35
12/3/2020,5,4,5,1,5,1,21
12/4/2020,5,2,1,4,5,1,18
12/5/2020,14,4,8,2,9,2,39
12/6/2020,7,6,5,4,8,2,32
12/7/2020,9,6,5,2,5,1,28
12/8/2020,12,7,1,1,6,3,30
12/9/2020,8,7,4,3,4,2,28
12/10/2020,6,1,3,2,3,2,17
12/11/2020,3,3,1,0,2,0,9
12/12/2020,15,4,4,5,3,3,34
12/13/2020,4,1,2,0,2,1,10
12/14/2020,10,6,3,6,5,2,32
12/15/2020,9,6,1,1,1,2,20
12/16/2020,6,2,2,0,3,2,15
12/17/2020,8,1,1,1,7,1,19
12/18/2020,4,5,4,3,2,2,20
12/19/2020,8,4,4,1,4,2,23
12/20/2020,14,9,1,3,2,1,30
12/21/2020,9,3,2,1,5,2,22
12/22/2020,4,0,2,0,0,0,6
12/23/2020,3,1,0,0,3,1,8
12/24/2020,6,3,5,1,3,1,19
12/25/2020,5,2,5,2,6,1,21
12/26/2020,4,3,2,5,5,1,20
12/27/2020,8,6,1,2,7,1,25
12/28/2020,13,4,3,1,3,3,27
12/29/2020,9,5,3,4,1,0,22
12/30/2020,9,4,2,2,3,0,20
12/31/2020,5,2,8,2,3,2,22
1/1/2021,7,3,4,1,2,3,20
1/2/2021,5,3,1,1,1,1,12
1/3/2021,8,6,2,0,2,3,21
1/4/2021,5,0,1,0,1,3,10
1/5/2021,4,1,1,0,3,1,10
1/6/2021,5,4,1,0,6,0,16
1/7/2021,6,1,2,2,2,1,14
1/8/2021,3,1,3,0,2,3,12
1/9/2021,4,0,3,1,1,2,11
1/10/2021,3,4,1,1,1,2,12
1/11/2021,8,5,1,0,2,2,18
1/12/2021,2,3,1,1,1,2,10
1/13/2021,8,2,4,2,1,2,19
1/14/2021,6,4,0,2,4,2,18
1/15/2021,11,2,6,0,2,3,24
1/16/2021,4,3,2,0,1,2,12
1/17/2021,2,0,2,0,1,2,7
1/18/2021,3,1,4,1,2,1,12
1/19/2021,0,0,3,0,2,2,7
1/20/2021,6,1,1,3,0,4,15
1/21/2021,8,5,3,4,3,0,23
1/22/2021,3,0,2,1,0,0,6
1/23/2021,9,4,0,1,3,0,17
1/24/2021,2,0,0,3,0,0,5
1/25/2021,2,1,1,0,0,1,5
1/26/2021,0,0,2,0,0,0,2
1/27/2021,4,0,2,1,0,2,9
1/28/2021,8,0,2,1,4,1,16
1/29/2021,6,1,1,0,2,2,12
1/30/2021,4,2,3,1,3,2,15
1/31/2021,1,2,1,0,3,1,8
2/1/2021,1,0,0,0,1,0,2
2/2/2021,5,2,0,0,3,3,13
2/3/2021,9,3,4,1,2,1,20
2/4/2021,4,0,10,1,3,3,21
2/5/2021,6,3,10,1,2,0,22
2/6/2021,4,1,0,1,2,0,8
2/7/2021,2,1,0,1,0,0,4
2/8/2021,0,1,1,0,4,0,6
2/9/2021,5,1,2,2,1,0,11
2/10/2021,5,4,5,1,2,2,19
2/11/2021,4,4,3,2,2,3,18
2/12/2021,6,2,0,2,3,2,15
2/13/2021,7,4,3,0,1,1,16
2/14/2021,3,4,3,3,1,0,14
2/15/2021,5,0,0,0,3,0,8
2/16/2021,4,2,1,1,1,1,10
2/17/2021,2,2,0,0,1,1,6
2/18/2021,8,1,1,0,6,4,20
2/19/2021,6,3,2,4,2,1,18
2/20/2021,5,2,2,2,0,0,11
2/21/2021,1,0,1,1,1,2,6
2/22/2021,2,2,1,1,0,1,7
2/23/2021,2,0,5,0,2,0,9
2/24/2021,2,1,1,1,0,0,5
2/25/2021,10,2,1,1,1,3,18
2/26/2021,7,2,2,0,3,1,15
2/27/2021,6,0,0,1,0,3,10
2/28/2021,4,6,2,1,2,1,16
3/1/2021,3,1,3,0,1,0,8
3/2/2021,2,1,3,2,1,0,9
3/3/2021,3,1,3,0,1,3,11
3/4/2021,0,0,0,0,0,0,0
3/5/2021,3,0,2,1,1,1,8
3/6/2021,3,2,2,1,2,0,10
3/7/2021,4,3,0,0,1,1,9
3/8/2021,3,2,0,0,1,0,6
3/9/2021,4,1,0,1,1,1,8
3/10/2021,4,3,3,1,2,2,15
3/11/2021,6,1,5,0,0,0,12
3/12/2021,5,5,5,0,1,3,19
3/13/2021,6,1,3,2,1,2,15
3/14/2021,3,0,1,2,0,3,9
3/15/2021,7,3,1,0,0,2,13
3/16/2021,2,1,3,1,1,1,9
3/17/2021,2,0,1,0,1,2,6
3/18/2021,6,2,5,0,3,1,17
3/19/2021,5,3,1,2,4,4,19
3/20/2021,2,0,3,1,1,0,7
3/21/2021,4,5,3,3,1,0,16
3/22/2021,2,0,3,1,2,0,8
3/23/2021,6,1,5,1,1,2,16
3/24/2021,4,2,1,1,1,2,11
3/25/2021,3,2,2,0,1,0,8
3/26/2021,3,4,1,2,0,1,11
3/27/2021,7,1,2,0,1,1,12
3/28/2021,4,2,1,0,0,1,8
3/29/2021,6,3,4,0,0,2,15
3/30/2021,2,0,0,0,0,1,3
3/31/2021,2,1,1,1,0,1,6
4/1/2021,4,3,5,0,0,2,14
4/2/2021,5,1,4,0,1,4,15
4/3/2021,8,6,1,1,0,2,18
4/4/2021,4,2,1,0,2,1,10
4/5/2021,7,2,3,1,1,3,17
4/6/2021,3,1,0,3,2,1,10
4/7/2021,6,2,2,1,2,1,14
4/8/2021,9,3,0,1,3,0,16
4/9/2021,3,1,1,0,2,3,10
4/10/2021,4,2,3,1,1,0,11
4/11/2021,3,2,2,3,0,1,11
4/12/2021,2,1,2,2,0,1,8
4/13/2021,5,3,2,2,2,0,14
4/14/2021,4,0,4,0,0,3,11
4/15/2021,2,0,2,1,0,0,5
4/16/2021,5,1,2,1,1,0,10
4/17/2021,5,0,0,2,0,2,9
4/18/2021,4,0,0,1,1,2,8
4/19/2021,3,2,4,2,3,1,15
4/20/2021,5,3,3,1,1,1,14
4/21/2021,7,6,5,0,0,4,22
4/22/2021,6,7,4,1,1,1,20
4/23/2021,5,2,3,1,1,0,12
4/24/2021,8,4,2,2,1,1,18
4/25/2021,4,0,0,0,0,2,6
4/26/2021,4,0,1,2,0,1,8
4/27/2021,1,0,3,0,1,2,7
4/28/2021,1,0,0,0,0,1,2
4/29/2021,5,4,0,1,1,1,12
4/30/2021,6,2,1,0,4,1,14
5/1/2021,4,1,3,0,1,1,10
5/2/2021,8,1,0,1,0,3,13
5/3/2021,2,3,2,2,1,0,10
5/4/2021,4,2,1,1,2,2,12
5/5/2021,10,5,3,1,1,0,20
5/6/2021,4,0,3,1,1,2,11
5/7/2021,4,5,2,2,1,0,14
5/8/2021,2,2,0,1,1,2,8
5/9/2021,5,2,3,0,0,3,13
5/10/2021,2,1,2,1,0,2,8
5/11/2021,5,1,4,0,1,1,12
5/12/2021,2,1,2,0,0,0,5
5/13/2021,5,1,1,0,1,3,11
5/14/2021,4,1,2,0,1,0,8
5/15/2021,7,2,1,1,3,2,16
5/16/2021,8,2,3,3,2,1,19
5/17/2021,3,1,3,1,1,1,10
5/18/2021,6,1,2,0,0,1,10
5/19/2021,6,2,2,1,1,0,12
5/20/2021,4,3,3,1,1,2,14
5/21/2021,3,1,1,3,1,3,12
5/22/2021,7,2,4,1,1,0,15
5/23/2021,8,2,3,2,1,1,17
5/24/2021,5,2,3,1,0,2,13
5/25/2021,2,0,5,0,0,1,8
5/26/2021,3,1,4,0,1,0,9
5/27/2021,5,3,3,3,1,1,16
5/28/2021,6,1,3,1,0,0,11
5/29/2021,2,0,1,1,1,0,5
5/30/2021,4,2,4,0,0,4,14
5/31/2021,4,2,4,0,0,2,12
6/1/2021,3,0,4,0,0,1,8
6/2/2021,7,4,3,3,0,1,18
6/3/2021,6,3,2,3,1,0,15
6/4/2021,7,4,0,2,2,1,16
6/5/2021,2,1,2,0,1,1,7
6/6/2021,7,3,1,1,0,2,14
6/7/2021,3,1,2,1,1,0,8
6/8/2021,6,3,3,1,0,0,13
6/9/2021,5,7,2,1,1,2,18
6/10/2021,4,4,1,0,2,0,11
6/11/2021,6,7,0,3,2,3,21
6/12/2021,4,2,1,1,0,1,9
6/13/2021,5,2,6,1,1,1,16
6/14/2021,5,2,1,1,2,2,13
6/15/2021,8,4,5,1,0,1,19
6/16/2021,3,1,1,0,1,0,6
6/17/2021,7,1,0,1,2,2,13
6/18/2021,6,4,2,1,1,1,15
6/19/2021,4,2,3,1,2,0,12
6/20/2021,6,3,3,3,0,3,18
6/21/2021,9,2,7,0,0,2,20
6/22/2021,2,0,1,0,0,1,4
6/23/2021,3,1,3,3,1,1,12
6/24/2021,12,6,6,1,1,4,30
6/25/2021,4,2,4,1,0,2,13
6/26/2021,7,3,3,2,1,1,17
6/27/2021,6,4,1,0,0,2,13
6/28/2021,6,5,4,2,2,1,20
6/29/2021,2,1,1,0,2,1,7
6/30/2021,6,5,6,1,1,1,20
7/1/2021,7,3,6,3,0,2,21
7/2/2021,8,4,2,2,3,3,22
7/3/2021,9,3,2,2,0,5,21
7/4/2021,5,1,6,0,1,2,15
7/5/2021,6,2,4,1,0,0,13
7/6/2021,6,1,2,0,1,3,13
7/7/2021,1,3,2,4,0,4,14
7/8/2021,4,1,0,0,1,2,8
7/9/2021,9,2,3,0,0,2,16
7/10/2021,2,1,3,0,0,1,7
7/11/2021,4,4,2,0,2,4,16
7/12/2021,4,4,3,2,1,1,15
7/13/2021,8,3,1,0,1,1,14
7/14/2021,7,1,4,1,1,1,15
7/15/2021,4,1,2,0,0,1,8
7/16/2021,8,4,4,1,0,3,20
7/17/2021,5,1,2,1,1,1,11
7/18/2021,5,3,4,2,1,1,16
7/19/2021,3,4,3,1,0,1,12
7/20/2021,3,0,4,0,0,2,9
7/21/2021,6,1,2,1,3,0,13
7/22/2021,8,2,2,3,0,2,17
7/23/2021,5,2,1,2,4,1,15
7/24/2021,6,4,3,0,0,3,16
7/25/2021,3,3,4,1,1,3,15
7/26/2021,8,3,2,0,1,2,16
7/27/2021,7,3,5,0,1,5,21
7/28/2021,5,2,1,1,2,1,12
7/29/2021,9,6,6,3,1,3,28
7/30/2021,7,2,2,3,2,2,18
7/31/2021,3,1,2,0,2,1,9
8/1/2021,6,2,3,1,0,2,14
8/2/2021,5,2,3,1,2,0,13
8/3/2021,10,5,1,0,2,1,19
8/4/2021,8,3,2,1,0,1,15
8/5/2021,11,7,0,1,0,1,20
8/6/2021,6,4,3,1,0,0,14
8/7/2021,5,5,4,0,0,1,15
8/8/2021,12,7,2,2,0,2,25
8/9/2021,6,3,4,1,0,3,17
8/10/2021,4,3,4,2,0,1,14
8/11/2021,5,2,4,1,0,2,14
8/12/2021,2,1,0,0,0,1,4
8/13/2021,3,3,2,0,0,0,8
8/14/2021,5,6,4,1,2,0,18
8/15/2021,5,5,4,1,0,3,18
8/16/2021,2,0,2,1,0,0,5
8/17/2021,3,1,5,1,3,1,14
8/18/2021,10,4,5,0,2,2,23
8/19/2021,5,3,2,0,0,1,11
8/20/2021,8,5,2,3,2,1,21
8/21/2021,10,5,2,3,2,3,25
8/22/2021,6,1,1,1,1,2,12
8/23/2021,4,2,1,2,1,1,11
8/24/2021,9,4,1,1,2,1,18
8/25/2021,9,3,4,0,0,2,18
8/26/2021,7,3,1,1,1,1,14
8/27/2021,6,5,4,4,1,4,24
8/28/2021,6,3,0,2,1,0,12
8/29/2021,9,4,2,2,1,0,18
8/30/2021,3,3,0,0,0,1,7
8/31/2021,0,2,2,0,2,2,8
9/1/2021,1,1,5,2,2,2,13
9/2/2021,6,3,2,1,2,2,16
9/3/2021,7,2,2,0,0,4,15
9/4/2021,7,5,6,2,0,1,21
9/5/2021,8,9,2,2,3,2,26
9/6/2021,11,6,4,3,2,1,27
9/7/2021,5,6,5,0,5,2,23
9/8/2021,9,3,4,3,0,1,20
9/9/2021,4,2,1,0,2,1,10
9/10/2021,4,0,1,1,1,1,8
9/11/2021,9,5,1,1,0,1,17
9/12/2021,5,3,1,0,2,1,12
9/13/2021,2,0,1,1,0,0,4
9/14/2021,1,4,6,0,1,3,15
9/15/2021,6,2,4,0,2,2,16
9/16/2021,9,3,6,2,1,0,21
9/17/2021,10,6,0,3,2,1,22
9/18/2021,1,2,1,0,1,2,7
9/19/2021,9,5,4,2,1,1,22
9/20/2021,9,7,1,2,1,2,22
9/21/2021,11,1,3,3,2,5,25
9/22/2021,8,5,3,2,2,4,24
9/23/2021,8,4,5,1,2,2,22
9/24/2021,5,1,1,2,1,3,13
9/25/2021,5,1,4,1,0,3,14
9/26/2021,11,4,5,1,1,4,26
9/27/2021,3,3,2,0,2,2,12
9/28/2021,2,5,0,1,2,2,12
9/29/2021,3,2,0,1,0,1,7
9/30/2021,6,2,6,2,0,2,18
10/1/2021,6,0,1,0,0,1,8
10/2/2021,6,4,0,1,1,1,13
10/3/2021,3,2,3,1,1,1,11
10/4/2021,10,6,4,2,1,1,24
10/5/2021,3,2,2,0,1,0,8
10/6/2021,2,1,3,1,0,0,7
10/7/2021,8,3,0,2,1,3,17
10/8/2021,3,0,0,0,3,2,8
10/9/2021,3,1,2,2,1,2,11
10/10/2021,8,9,2,1,4,1,25
10/11/2021,8,6,3,1,3,6,27
10/12/2021,3,1,2,0,0,1,7
10/13/2021,6,3,2,0,1,2,14
10/14/2021,4,4,1,0,2,1,12
10/15/2021,8,4,3,0,1,0,16
10/16/2021,2,0,4,1,1,1,9
10/17/2021,1,0,1,0,2,1,5
10/18/2021,2,1,2,0,2,2,9
10/19/2021,3,2,2,0,0,0,7
10/20/2021,1,1,7,0,1,0,10
10/21/2021,3,3,2,0,0,1,9
10/22/2021,11,6,1,5,2,3,28
10/23/2021,8,7,2,1,2,1,21
10/24/2021,11,3,0,0,2,4,20
10/25/2021,6,2,2,4,2,4,20
10/26/2021,2,2,4,0,1,1,10
10/27/2021,6,0,0,1,0,1,8
10/28/2021,6,3,2,2,1,1,15
10/29/2021,3,6,1,0,0,0,10
10/30/2021,4,1,0,1,2,1,9
10/31/2021,4,2,3,0,1,2,12
11/1/2021,5,2,6,0,0,5,18
11/2/2021,2,2,4,1,1,2,12
11/3/2021,6,6,2,2,2,2,20
11/4/2021,3,3,3,1,3,0,13
11/5/2021,1,0,1,0,0,0,2
11/6/2021,11,8,2,1,3,2,27
11/7/2021,5,2,1,0,3,0,11
11/8/2021,1,0,1,0,0,3,5
11/9/2021,2,2,0,1,1,1,7
11/10/2021,3,1,2,1,3,2,12
11/11/2021,2,1,2,2,3,1,11
11/12/2021,6,3,1,3,3,3,19
11/13/2021,7,4,1,1,2,2,17
11/14/2021,4,1,1,0,0,0,6
11/15/2021,2,1,1,0,1,0,5
11/16/2021,2,1,3,0,1,0,7
11/17/2021,3,1,0,0,1,2,7
11/18/2021,1,1,0,2,0,2,6
11/19/2021,9,4,1,1,2,2,19
11/20/2021,7,3,1,1,4,2,18
11/21/2021,5,3,0,0,1,1,10
11/22/2021,1,1,2,1,0,1,6
11/23/2021,1,1,3,0,0,3,8
11/24/2021,3,3,0,1,1,6,14
11/25/2021,4,3,1,1,2,2,13
11/26/2021,6,2,3,2,3,1,17
11/27/2021,10,5,2,2,3,1,23
11/28/2021,1,0,1,1,2,1,6
11/29/2021,4,5,3,1,3,1,17
11/30/2021,3,2,1,0,1,1,8
12/1/2021,2,0,3,0,4,0,9
12/2/2021,0,1,0,0,1,0,2
12/3/2021,6,1,3,0,1,3,14
12/4/2021,7,3,2,0,0,3,15
12/5/2021,6,1,2,1,1,3,14
12/6/2021,1,3,6,2,2,2,16
12/7/2021,2,0,2,0,0,2,6
12/8/2021,3,3,2,1,2,0,11
12/9/2021,4,1,4,0,1,0,10
12/10/2021,5,3,0,2,1,1,12
12/11/2021,6,3,5,1,1,2,18
12/12/2021,7,1,2,0,1,4,15
12/13/2021,6,1,3,0,3,1,14
12/14/2021,5,2,3,1,3,4,18
12/15/2021,8,3,3,2,4,2,22
12/16/2021,10,2,7,0,1,2,22
12/17/2021,3,3,0,1,2,0,9
12/18/2021,6,2,1,1,5,0,15
12/19/2021,5,1,2,1,1,2,12
12/20/2021,2,2,0,1,3,1,9
12/21/2021,5,2,2,0,2,1,12
12/22/2021,2,3,3,1,1,0,10
12/23/2021,4,2,1,2,1,0,10
12/24/2021,4,1,1,1,1,0,8
12/25/2021,4,1,1,0,1,0,7
12/26/2021,3,2,1,2,3,0,11
12/27/2021,1,1,0,4,0,0,6
12/28/2021,8,2,2,1,4,0,17
12/29/2021,9,3,1,1,1,1,16
12/30/2021,11,7,3,1,4,2,28
12/31/2021,6,5,2,2,2,1,18
1/1/2022,5,2,4,1,5,2,19
1/2/2022,12,10,4,0,3,2,31
1/3/2022,13,6,4,3,4,1,31
1/4/2022,15,6,5,4,1,4,35
1/5/2022,6,5,1,2,2,2,18
1/6/2022,7,4,3,3,1,0,18
1/7/2022,3,2,4,3,2,0,14
1/8/2022,7,0,1,5,1,0,14
1/9/2022,6,9,4,1,2,4,26
1/10/2022,11,5,3,2,5,1,27
1/11/2022,7,3,2,4,3,1,20
1/12/2022,5,3,4,2,1,4,19
1/13/2022,3,4,5,3,1,1,17
1/14/2022,6,3,1,3,2,1,16
1/15/2022,10,4,5,0,7,0,26
1/16/2022,7,5,4,1,1,5,23
1/17/2022,12,8,1,2,4,3,30
1/18/2022,10,6,3,4,7,0,30
1/19/2022,5,6,3,4,5,0,23
1/20/2022,10,9,6,3,3,2,33
1/21/2022,4,2,0,3,4,0,13
1/22/2022,12,7,5,3,3,0,30
1/23/2022,15,13,6,2,3,0,39
1/24/2022,15,11,6,5,7,3,47
1/25/2022,10,3,9,3,9,0,34
1/26/2022,19,9,7,4,3,3,45
1/27/2022,5,2,3,0,4,1,15
1/28/2022,5,2,1,2,5,1,16
1/29/2022,6,4,2,2,1,2,17
1/30/2022,11,5,5,3,2,2,28
1/31/2022,10,5,3,4,4,0,26
2/1/2022,15,5,3,7,7,2,39
2/2/2022,3,2,2,0,3,2,12
2/3/2022,6,3,2,2,1,2,16
2/4/2022,11,6,1,3,4,2,27
2/5/2022,6,3,2,2,4,0,17
2/6/2022,14,8,6,5,6,3,42
2/7/2022,10,8,4,2,4,2,30
2/8/2022,11,3,2,5,5,0,26
2/9/2022,17,5,3,3,4,3,35
2/10/2022,4,1,2,0,4,1,12
2/11/2022,6,3,1,1,6,3,20
2/12/2022,11,5,5,1,6,2,30
2/13/2022,9,7,2,1,3,1,23
2/14/2022,7,2,1,3,2,1,16
2/15/2022,16,8,5,1,1,2,33
2/16/2022,9,6,2,7,2,1,27
2/17/2022,8,2,1,3,1,1,16
2/18/2022,7,3,4,3,1,3,21
2/19/2022,13,6,2,4,4,1,30
2/20/2022,6,5,1,2,5,2,21
2/21/2022,7,7,1,0,5,0,20
2/22/2022,6,3,5,1,4,2,21
2/23/2022,11,10,2,2,3,2,30
2/24/2022,11,2,3,5,1,3,25
2/25/2022,15,10,3,1,6,5,40
2/26/2022,13,5,1,1,2,4,26
2/27/2022,21,9,4,6,5,4,49
2/28/2022,11,5,1,2,3,2,24
3/1/2022,8,2,3,3,3,2,21
3/2/2022,10,6,4,0,4,1,25
3/3/2022,5,3,1,3,1,1,14
3/4/2022,4,6,4,1,1,3,19
3/5/2022,13,10,4,5,1,2,35
3/6/2022,6,2,1,1,1,4,15
3/7/2022,16,7,5,5,0,2,35
3/8/2022,15,6,3,4,3,2,33
3/9/2022,7,7,2,2,3,1,22
3/10/2022,9,7,4,5,3,1,29
3/11/2022,16,4,5,3,5,2,35
3/12/2022,7,0,3,1,2,2,15
3/13/2022,4,0,4,1,2,0,11
3/14/2022,13,8,2,4,6,1,34
3/15/2022,7,7,2,1,3,2,22
3/16/2022,2,5,5,3,2,2,19
3/17/2022,15,5,3,1,2,2,28
3/18/2022,13,6,2,1,3,2,27
3/19/2022,9,9,6,5,5,3,37
3/20/2022,17,12,8,5,3,1,46
3/21/2022,12,7,0,5,2,0,26
3/22/2022,13,8,7,3,5,0,36
3/23/2022,9,3,5,3,3,0,23
3/24/2022,9,8,2,4,1,1,25
3/25/2022,2,3,6,2,2,3,18
3/26/2022,8,1,3,3,1,0,16
3/27/2022,6,5,2,2,1,1,17
3/28/2022,8,4,3,0,2,4,21
3/29/2022,5,4,1,4,1,0,15
3/30/2022,8,2,1,3,3,0,17
3/31/2022,10,5,5,2,5,1,28
4/1/2022,6,3,0,1,1,1,12
4/2/2022,15,9,2,5,8,2,41
4/3/2022,11,5,2,1,6,1,26
4/4/2022,16,6,3,3,4,3,35
4/5/2022,16,11,8,5,0,0,40
4/6/2022,6,6,3,1,2,3,21
4/7/2022,7,4,3,2,2,2,20
4/8/2022,10,5,1,5,4,3,28
4/9/2022,6,3,2,4,1,4,20
4/10/2022,15,11,2,2,3,1,34
4/11/2022,7,6,3,4,0,2,22
4/12/2022,14,6,3,2,3,1,29
4/13/2022,7,3,4,2,4,1,21
4/14/2022,9,6,5,7,1,3,31
4/15/2022,15,10,6,5,3,1,40
4/16/2022,10,2,2,1,0,2,17
4/17/2022,12,8,3,2,4,1,30
4/18/2022,9,6,3,2,3,1,24
4/19/2022,7,6,1,3,1,1,19
4/20/2022,8,3,3,0,2,2,18
4/21/2022,4,5,1,2,2,2,16
4/22/2022,10,3,4,7,4,0,28
4/23/2022,7,5,1,4,3,1,21
4/24/2022,6,1,2,2,1,4,16
4/25/2022,13,3,7,2,0,2,27
4/26/2022,11,8,1,5,3,1,29
4/27/2022,7,0,3,3,4,4,21
4/28/2022,6,1,0,2,1,1,11
4/29/2022,8,4,4,3,2,1,22
4/30/2022,23,8,5,6,3,5,50
5/1/2022,12,10,2,3,4,0,31
5/2/2022,6,2,3,4,1,0,16
5/3/2022,7,6,4,3,5,0,25
5/4/2022,3,5,1,5,3,1,18
5/5/2022,6,3,7,0,1,3,20
5/6/2022,9,5,8,3,1,0,26
5/7/2022,13,10,9,9,4,3,48
5/8/2022,9,6,8,3,7,1,34
5/9/2022,7,1,2,2,5,0,17
5/10/2022,17,16,8,6,4,1,52
5/11/2022,8,9,6,0,4,1,28
5/12/2022,12,8,6,2,2,0,30
5/13/2022,8,6,7,1,6,1,29
5/14/2022,7,4,6,4,0,2,23
5/15/2022,6,2,2,1,0,0,11
5/16/2022,7,8,3,4,4,0,26
5/17/2022,13,9,1,4,1,1,29
5/18/2022,9,9,3,2,1,3,27
5/19/2022,4,2,3,2,1,2,14
5/20/2022,12,10,3,4,6,0,35
5/21/2022,14,9,0,4,3,2,32
5/22/2022,15,12,3,5,2,1,38
5/23/2022,15,11,5,5,3,0,39
5/24/2022,11,4,6,0,1,5,27
5/25/2022,9,4,3,3,1,2,22
5/26/2022,5,2,4,1,1,0,13
5/27/2022,9,9,4,3,3,3,31
5/28/2022,7,2,1,1,2,1,14
5/29/2022,8,4,5,2,0,1,20
5/30/2022,9,7,4,4,0,0,24
5/31/2022,7,6,3,2,2,1,21
6/1/2022,10,1,4,2,0,1,18
6/2/2022,4,4,3,1,4,1,17
6/3/2022,15,12,8,2,4,1,42
6/4/2022,16,13,5,4,4,2,44
6/5/2022,10,3,1,1,4,1,20
6/6/2022,6,6,4,1,0,2,19
6/7/2022,9,2,2,3,2,1,19
6/8/2022,13,7,3,3,5,2,33
6/9/2022,3,2,1,3,3,1,13
6/10/2022,17,10,6,1,4,4,42
6/11/2022,8,4,3,2,1,1,19
6/12/2022,8,8,1,3,0,0,20
6/13/2022,9,6,1,1,2,2,21
6/14/2022,8,5,6,1,2,0,22
6/15/2022,6,2,4,3,2,1,18
6/16/2022,11,2,6,3,2,5,29
6/17/2022,18,7,4,6,5,5,45
6/18/2022,9,5,2,2,4,3,25
6/19/2022,8,5,3,0,3,2,21
6/20/2022,9,5,5,5,1,2,27
6/21/2022,4,2,0,0,1,2,9
6/22/2022,5,1,2,0,0,1,9
6/23/2022,6,2,2,2,0,3,15
6/24/2022,11,7,4,4,1,0,27
6/25/2022,14,8,5,1,1,2,31
6/26/2022,8,7,0,2,1,1,19
6/27/2022,4,1,4,2,0,2,13
6/28/2022,4,3,1,2,2,1,13
6/29/2022,5,3,3,0,0,1,12
6/30/2022,7,1,4,2,1,2,17
7/1/2022,9,5,4,2,0,3,23
7/2/2022,13,6,1,6,0,2,28
7/3/2022,12,2,1,0,3,1,19
7/4/2022,8,3,3,4,1,1,20
7/5/2022,6,4,6,5,3,1,25
7/6/2022,24,12,2,6,3,3,50
7/7/2022,9,5,5,2,2,2,25
7/8/2022,21,11,6,7,2,1,48
7/9/2022,5,5,4,4,1,2,21
7/10/2022,17,7,4,7,1,0,36
7/11/2022,12,5,3,1,2,4,27
7/12/2022,9,5,3,0,1,0,18
7/13/2022,9,5,2,4,2,2,24
7/14/2022,4,6,1,3,2,0,16
7/15/2022,6,5,2,2,0,2,17
7/16/2022,6,3,3,2,3,0,17
7/17/2022,9,5,1,2,0,2,19
7/18/2022,20,14,8,3,4,4,53
7/19/2022,9,5,2,4,0,4,24
7/20/2022,6,6,2,2,3,1,20
7/21/2022,9,5,2,3,2,1,22
7/22/2022,8,6,2,5,1,3,25
7/23/2022,7,10,2,1,0,4,24
7/24/2022,5,0,4,0,0,2,11
7/25/2022,7,3,1,1,1,1,14
7/26/2022,8,2,3,2,1,4,20
7/27/2022,3,1,2,4,2,1,13
7/28/2022,6,3,1,1,1,1,13
7/29/2022,11,4,3,4,1,0,23
7/30/2022,8,4,6,6,1,3,28
7/31/2022,4,2,3,3,1,0,13
8/1/2022,10,6,5,1,2,0,24
8/2/2022,4,4,1,1,2,0,12
8/3/2022,7,2,3,2,0,3,17
8/4/2022,9,2,2,3,1,2,19
8/5/2022,14,5,5,5,0,3,32
8/6/2022,5,4,2,1,3,0,15
8/7/2022,4,5,5,3,1,0,18
8/8/2022,10,3,6,4,3,2,28
8/9/2022,5,2,2,1,0,0,10
8/10/2022,8,3,3,5,2,1,22
8/11/2022,9,5,5,3,1,1,24
8/12/2022,8,6,1,2,1,1,19
8/13/2022,9,5,7,1,1,1,24
8/14/2022,15,12,3,2,4,0,36
8/15/2022,9,4,5,1,0,2,21
8/16/2022,4,6,2,0,1,2,15
8/17/2022,4,1,0,1,0,0,6
8/18/2022,3,2,0,1,0,0,6
8/19/2022,12,4,4,1,4,1,26
8/20/2022,9,4,2,2,2,1,20
8/21/2022,4,2,4,0,0,2,12
8/22/2022,14,8,6,3,3,1,35
8/23/2022,5,8,1,0,3,2,19
8/24/2022,8,5,3,2,2,1,21
8/25/2022,6,4,3,1,2,2,18
8/26/2022,5,3,2,3,1,1,15
8/27/2022,6,2,3,2,1,4,18
8/28/2022,8,2,3,1,3,1,18
8/29/2022,3,4,2,1,1,1,12
8/30/2022,10,9,3,3,1,2,28
8/31/2022,6,4,0,3,3,1,17
9/1/2022,7,7,3,2,1,0,20
9/2/2022,5,3,8,4,2,1,23
9/3/2022,11,6,5,7,3,1,33
9/4/2022,11,6,7,5,2,3,34
9/5/2022,8,4,2,2,0,0,16
9/6/2022,5,4,5,1,2,0,17
9/7/2022,12,6,2,3,3,2,28
9/8/2022,10,8,6,2,5,3,34
9/9/2022,20,11,6,2,1,2,42
9/10/2022,6,6,2,2,4,5,25
9/11/2022,8,9,6,4,2,3,32
9/12/2022,31,15,14,5,6,2,73
9/13/2022,10,4,5,3,2,3,27
9/14/2022,35,19,17,10,9,2,92
9/15/2022,15,7,5,3,4,6,40
9/16/2022,17,10,5,4,2,4,42
9/17/2022,10,6,2,5,1,1,25
9/18/2022,23,8,5,5,1,0,42
9/19/2022,13,3,6,4,0,2,28
9/20/2022,12,4,1,3,0,0,20
9/21/2022,11,10,7,2,2,2,34
9/22/2022,5,5,3,5,3,2,23
9/23/2022,17,13,7,5,5,2,49
9/24/2022,13,4,4,4,3,2,30
9/25/2022,10,4,6,2,2,1,25
9/26/2022,8,3,2,0,6,1,20
9/27/2022,17,10,6,4,4,5,46
9/28/2022,13,5,5,2,3,2,30
9/29/2022,9,1,6,3,2,3,24
9/30/2022,8,5,1,1,0,0,15
10/1/2022,4,5,6,3,0,1,19
10/2/2022,8,8,4,2,2,1,25
10/3/2022,10,4,3,3,2,1,23
10/4/2022,3,6,2,0,3,1,15
10/5/2022,12,4,3,6,0,3,28
10/6/2022,12,4,5,1,2,5,29
10/7/2022,10,4,4,1,1,4,24
10/8/2022,17,2,3,3,1,0,26
10/9/2022,24,8,8,7,1,6,54
10/10/2022,7,6,4,2,5,2,26
10/11/2022,9,7,4,3,2,3,28
10/12/2022,10,5,6,3,2,0,26
10/13/2022,21,6,9,6,8,4,54
10/14/2022,11,7,3,5,3,3,32
10/15/2022,15,6,2,3,4,1,31
10/16/2022,7,5,2,2,3,2,21
10/17/2022,6,2,4,2,2,1,17
10/18/2022,8,3,1,2,2,2,18
10/19/2022,5,5,3,2,0,0,15
10/20/2022,9,6,12,5,5,2,39
10/21/2022,6,4,1,3,5,1,20
10/22/2022,13,9,3,3,2,3,33
10/23/2022,6,2,2,1,4,0,15
10/24/2022,8,5,0,2,2,0,17
10/25/2022,18,6,6,4,3,3,40
10/26/2022,9,7,2,2,3,1,24
10/27/2022,12,5,3,2,1,1,24
10/28/2022,10,6,3,10,5,0,34
10/29/2022,12,5,3,6,4,6,36
10/30/2022,7,7,1,7,2,2,26
10/31/2022,10,7,4,8,2,2,33
11/1/2022,13,7,3,4,3,1,31
11/2/2022,6,2,4,6,0,1,19
11/3/2022,8,4,2,2,4,1,21
11/4/2022,18,7,5,1,3,2,36
11/5/2022,13,5,7,4,1,2,32
11/6/2022,13,6,2,3,3,2,29
11/7/2022,12,8,4,5,5,4,38
11/8/2022,4,7,3,3,1,1,19
11/9/2022,7,3,2,1,0,0,13
11/10/2022,5,3,6,3,1,0,18
11/11/2022,9,8,1,2,2,1,23
11/12/2022,10,5,2,2,0,3,22
11/13/2022,11,6,5,2,2,1,27
11/14/2022,14,9,1,5,1,3,33
11/15/2022,6,4,0,4,1,2,17
11/16/2022,4,3,8,2,2,2,21
11/17/2022,8,3,2,5,1,3,22
11/18/2022,4,2,2,1,1,3,13
11/19/2022,7,6,2,5,3,2,25
11/20/2022,5,1,2,3,1,2,14
11/21/2022,10,5,3,2,3,0,23
11/22/2022,13,9,3,4,7,0,36
11/23/2022,4,2,2,2,4,0,14
11/24/2022,5,4,5,3,1,0,18
11/25/2022,11,7,4,2,4,4,32
11/26/2022,17,4,2,3,1,0,27
11/27/2022,14,10,4,3,1,0,32
11/28/2022,12,6,5,3,3,2,31
11/29/2022,8,5,3,1,1,1,19
11/30/2022,3,2,2,2,3,0,12
12/1/2022,7,1,4,2,3,0,17
12/2/2022,15,9,3,8,0,2,37
12/3/2022,15,7,8,4,4,3,41
12/4/2022,13,5,2,3,2,3,28
12/5/2022,14,12,6,5,1,4,42
12/6/2022,8,6,4,4,1,2,25
12/7/2022,7,5,3,4,1,1,21
12/8/2022,11,6,6,4,1,1,29
12/9/2022,16,13,9,6,5,1,50
12/10/2022,10,10,2,1,3,1,27
12/11/2022,13,5,5,4,3,1,31
12/12/2022,8,4,4,2,3,4,25
12/13/2022,10,8,6,5,3,1,33
12/14/2022,8,1,4,4,3,1,21
12/15/2022,15,8,10,5,8,2,48
12/16/2022,11,6,5,4,3,0,29
12/17/2022,18,8,4,7,3,3,43
12/18/2022,7,4,1,2,2,1,17
12/19/2022,14,11,7,3,2,0,37
12/20/2022,25,16,9,5,2,3,60
12/21/2022,6,6,2,2,6,0,22
12/22/2022,9,6,3,3,4,1,26
12/23/2022,4,2,4,4,2,4,20
12/24/2022,9,4,7,3,4,1,28
12/25/2022,8,1,3,2,2,1,17
12/26/2022,12,8,1,2,4,2,29
12/27/2022,10,8,5,3,3,0,29
12/28/2022,7,4,5,2,0,1,19
12/29/2022,5,1,1,3,1,1,12
12/30/2022,14,8,2,7,7,4,42
12/31/2022,18,8,3,3,4,4,40
1/1/2023,8,2,5,0,3,3,21
1/2/2023,8,5,2,0,2,1,18
1/3/2023,6,3,1,1,1,1,13
1/4/2023,4,2,2,0,3,0,11
1/5/2023,6,5,0,4,2,1,18
1/6/2023,6,5,2,3,2,0,18
1/7/2023,5,2,0,1,1,2,11
1/8/2023,6,0,3,0,1,0,10
1/9/2023,5,4,1,0,2,0,12
1/10/2023,6,4,0,3,1,1,15
1/11/2023,4,0,3,2,2,2,13
1/12/2023,7,6,2,2,1,1,19
1/13/2023,5,3,5,0,0,1,14
1/14/2023,0,0,1,0,0,1,2
1/15/2023,5,4,1,1,0,3,14
1/16/2023,2,0,0,1,0,0,3
1/17/2023,3,2,0,1,2,0,8
1/18/2023,2,1,2,0,2,1,8
1/19/2023,2,3,1,0,1,0,7
1/20/2023,10,4,3,0,2,1,20
1/21/2023,8,1,1,2,1,2,15
1/22/2023,8,2,4,1,3,1,19
1/23/2023,4,3,1,1,3,3,15
1/24/2023,5,6,3,0,4,0,18
1/25/2023,6,2,0,1,0,1,10
1/26/2023,9,3,1,1,3,1,18
1/27/2023,5,2,1,0,1,0,9
1/28/2023,5,2,0,1,2,2,12
1/29/2023,7,3,2,4,2,2,20
1/30/2023,5,4,1,0,3,2,15
1/31/2023,7,2,0,0,2,4,15
2/1/2023,3,2,5,2,1,1,14
2/2/2023,5,2,6,1,0,1,15
2/3/2023,8,2,2,0,2,3,17
2/4/2023,6,3,2,1,6,0,18
2/5/2023,2,1,0,0,0,2,5
2/6/2023,5,1,5,1,1,4,17
2/7/2023,3,1,2,0,2,2,10
2/8/2023,3,1,2,1,1,0,8
2/9/2023,8,0,1,0,1,1,11
2/10/2023,7,5,3,2,1,0,18
2/11/2023,4,2,2,0,2,0,10
2/12/2023,1,0,0,2,0,0,3
2/13/2023,12,4,2,0,1,2,21
2/14/2023,6,1,0,2,3,4,16
2/15/2023,4,4,5,1,3,2,19
2/16/2023,5,4,0,0,1,1,11
2/17/2023,5,2,1,1,2,3,14
2/18/2023,3,2,0,1,2,1,9
2/19/2023,3,2,0,2,1,0,8
2/20/2023,3,2,2,2,1,1,11
2/21/2023,12,5,3,2,6,3,31
2/22/2023,9,4,1,0,8,2,24
2/23/2023,8,6,0,6,4,0,24
2/24/2023,12,6,5,3,3,3,32
2/25/2023,13,11,4,6,2,5,41
2/26/2023,14,9,7,3,3,0,36
2/27/2023,19,16,3,3,6,1,48
2/28/2023,8,6,1,1,4,3,23
3/1/2023,13,9,1,6,3,2,34
3/2/2023,13,11,4,6,2,5,41
3/3/2023,12,11,5,6,6,4,44
3/4/2023,7,9,3,1,7,4,31
3/5/2023,13,14,6,3,5,2,43
3/6/2023,9,8,2,2,1,1,23
3/7/2023,8,5,3,2,5,2,25
3/8/2023,8,4,4,1,6,3,26
3/9/2023,6,9,3,1,9,2,30
3/10/2023,9,6,3,0,4,4,26
3/11/2023,5,5,2,1,3,1,17
3/12/2023,9,11,2,2,11,4,39
3/13/2023,13,8,4,2,5,3,35
3/14/2023,8,4,3,0,4,1,20
3/15/2023,11,5,5,2,6,4,33
3/16/2023,8,9,6,2,2,2,29
3/17/2023,10,8,2,2,2,4,28
3/18/2023,10,11,1,2,6,1,31
3/19/2023,5,3,2,2,3,2,17
3/20/2023,6,2,1,1,1,0,11
3/21/2023,7,4,3,2,0,1,17
3/22/2023,2,3,0,1,1,1,8
3/23/2023,9,6,4,1,3,2,25
3/24/2023,3,6,1,1,2,1,14
3/25/2023,1,1,2,1,1,1,7
3/26/2023,3,1,2,1,1,1,9
3/27/2023,4,5,4,0,0,1,14
3/28/2023,8,7,3,0,4,2,24
3/29/2023,9,4,2,1,3,2,21
3/30/2023,6,4,1,2,2,2,17
3/31/2023,6,3,1,4,2,1,17
4/1/2023,11,5,5,3,0,2,26
4/2/2023,6,5,4,0,1,0,16
4/3/2023,1,1,1,0,0,1,4
4/4/2023,2,2,1,0,2,2,9
4/5/2023,6,4,4,1,0,3,18
4/6/2023,4,7,1,0,3,1,16
4/7/2023,7,6,5,0,2,1,21
4/8/2023,3,1,0,0,0,2,6
4/9/2023,5,1,1,3,0,5,15
4/10/2023,10,5,1,4,1,2,23
4/11/2023,8,6,4,1,2,2,23
4/12/2023,7,3,4,2,1,4,21
4/13/2023,4,4,2,2,0,1,13
4/14/2023,8,6,1,3,2,2,22
4/15/2023,4,3,1,0,0,2,10
4/16/2023,3,0,1,3,0,1,8
4/17/2023,6,7,2,3,3,1,22
4/18/2023,11,5,3,0,2,1,22
4/19/2023,7,3,2,1,4,1,18
4/20/2023,9,11,2,4,1,1,28
4/21/2023,8,5,3,1,0,1,18
4/22/2023,6,4,2,2,1,2,17
4/23/2023,8,9,5,1,3,1,27
4/24/2023,12,6,4,3,0,2,27
4/25/2023,4,6,2,4,0,3,19
4/26/2023,6,5,6,4,2,0,23
4/27/2023,5,4,3,3,0,5,20
4/28/2023,9,7,1,5,1,2,25
4/29/2023,6,3,2,1,1,1,14
4/30/2023,5,3,3,1,1,0,13
5/1/2023,4,3,2,1,1,4,15
5/2/2023,9,2,1,1,2,3,18
5/3/2023,6,4,3,3,0,2,18
5/4/2023,3,2,0,2,0,1,8
5/5/2023,9,3,2,1,2,3,20
5/6/2023,7,6,3,4,0,5,25
5/7/2023,5,6,4,0,1,4,20
5/8/2023,7,4,4,1,3,2,21
5/9/2023,8,5,4,3,2,5,27
5/10/2023,8,10,5,4,3,1,31
5/11/2023,10,5,2,2,2,4,25
5/12/2023,3,5,1,2,1,1,13
5/13/2023,9,5,2,2,1,2,21
5/14/2023,6,6,5,2,4,2,25
5/15/2023,9,6,2,2,3,1,23
5/16/2023,7,5,3,2,1,1,19
5/17/2023,8,4,3,3,2,5,25
5/18/2023,8,7,1,0,1,5,22
5/19/2023,10,7,4,1,2,2,26
5/20/2023,11,12,5,2,5,4,39
5/21/2023,11,11,3,5,3,3,36
5/22/2023,6,4,3,3,2,1,19
5/23/2023,6,4,1,6,1,2,20
5/24/2023,6,9,2,3,4,1,25
5/25/2023,4,1,3,2,1,2,13
5/26/2023,7,4,1,3,3,1,19
5/27/2023,8,4,2,4,2,2,22
5/28/2023,7,8,4,0,0,4,23
5/29/2023,8,5,1,3,2,3,22
5/30/2023,3,1,5,1,0,5,15
5/31/2023,4,4,3,2,0,2,15
6/1/2023,9,5,3,3,1,4,25
6/2/2023,8,5,6,1,0,2,22
6/3/2023,9,4,1,1,0,2,17
6/4/2023,5,3,2,0,3,2,15
6/5/2023,8,5,2,2,0,2,19
6/6/2023,8,3,2,1,2,2,18
6/7/2023,4,2,2,2,0,2,12
6/8/2023,11,4,5,2,3,5,30
6/9/2023,15,9,5,9,3,3,44
6/10/2023,4,1,1,0,0,1,7
6/11/2023,5,4,1,0,0,3,13
6/12/2023,7,6,4,0,1,1,19
6/13/2023,4,5,2,1,0,3,15
6/14/2023,11,3,3,2,2,5,26
6/15/2023,4,4,5,1,1,2,17
6/16/2023,11,5,3,3,3,6,31
6/17/2023,12,4,4,2,0,1,23
6/18/2023,13,9,3,5,3,2,35
6/19/2023,15,8,2,6,3,1,35
6/20/2023,5,11,3,4,2,1,26
6/21/2023,8,5,3,1,0,4,21
6/22/2023,3,2,1,2,0,1,9
6/23/2023,2,0,1,2,0,4,9
6/24/2023,10,8,3,5,1,3,30
6/25/2023,3,4,1,1,1,3,13
6/26/2023,6,6,1,2,0,0,15
6/27/2023,6,5,1,2,1,2,17
6/28/2023,5,4,2,2,0,1,14
6/29/2023,3,2,2,1,4,3,15
6/30/2023,6,6,1,1,1,1,16
7/1/2023,11,9,2,1,1,3,27
7/2/2023,9,7,2,1,4,2,25
7/3/2023,4,4,1,1,1,1,12
7/4/2023,11,5,5,2,3,1,27
7/5/2023,7,5,5,2,2,5,26
7/6/2023,8,2,2,2,3,4,21
7/7/2023,9,3,4,7,1,1,25
7/8/2023,13,6,4,4,3,7,37
7/9/2023,10,8,2,2,3,1,26
7/10/2023,3,4,1,1,1,6,16
7/11/2023,8,8,7,4,1,5,33
7/12/2023,6,7,3,1,2,1,20
7/13/2023,5,3,1,1,1,1,12
7/14/2023,4,3,3,1,3,2,16
7/15/2023,8,7,5,5,5,4,34
7/16/2023,10,5,7,0,2,3,27
7/17/2023,4,3,2,2,2,1,14
7/18/2023,3,3,1,4,0,2,13
7/19/2023,5,2,1,4,0,1,13
7/20/2023,8,3,4,1,1,1,18
7/21/2023,8,7,0,2,1,0,18
7/22/2023,8,6,1,0,3,1,19
7/23/2023,7,8,8,7,2,2,34
7/24/2023,10,6,4,4,2,3,29
7/25/2023,7,2,6,2,2,2,21
7/26/2023,5,0,2,3,0,2,12
7/27/2023,4,3,5,0,1,1,14
7/28/2023,9,3,1,0,0,1,14
7/29/2023,3,2,1,0,1,3,10
7/30/2023,6,3,6,0,1,0,16
7/31/2023,4,3,1,1,1,0,10
8/1/2023,9,4,1,1,2,2,19
8/2/2023,10,4,8,2,1,4,29
8/3/2023,2,1,0,0,0,1,4
8/4/2023,7,3,3,3,0,0,16
8/5/2023,15,6,4,1,2,4,32
8/6/2023,9,5,2,3,1,3,23
8/7/2023,3,3,3,1,0,2,12
8/8/2023,8,4,1,0,2,1,16
8/9/2023,6,3,5,4,1,2,21
8/10/2023,5,9,3,1,2,0,20
8/11/2023,12,10,3,3,1,6,35
8/12/2023,12,9,2,2,3,2,30
8/13/2023,9,4,4,0,1,0,18
8/14/2023,7,4,2,1,1,2,17
8/15/2023,4,4,5,3,0,2,18
8/16/2023,6,4,2,2,1,2,17
8/17/2023,8,7,6,2,0,1,24
8/18/2023,8,3,3,1,2,4,21
8/19/2023,9,5,6,2,3,2,27
8/20/2023,7,1,1,4,0,0,13
8/21/2023,12,8,5,3,0,3,31
8/22/2023,12,8,1,4,2,3,30
8/23/2023,8,4,5,2,4,3,26
8/24/2023,11,6,3,3,3,3,29
8/25/2023,6,6,2,2,0,0,16
8/26/2023,13,9,4,4,0,1,31
8/27/2023,6,5,3,3,1,1,19
8/28/2023,5,5,4,3,1,0,18
8/29/2023,9,2,3,1,2,2,19
8/30/2023,5,3,6,1,2,1,18
8/31/2023,10,6,4,0,1,2,23
9/1/2023,6,7,2,1,3,3,22
9/2/2023,3,5,1,4,0,1,14
9/3/2023,8,3,3,2,1,1,18
9/4/2023,8,6,4,1,0,1,20
9/5/2023,5,4,4,2,1,3,19
9/6/2023,8,9,1,2,1,1,22
9/7/2023,10,6,1,5,1,1,24
9/8/2023,5,4,6,1,0,3,19
9/9/2023,4,4,2,2,1,2,15
9/10/2023,0,1,2,1,0,2,6
9/11/2023,8,4,2,5,1,1,21
9/12/2023,7,3,1,0,0,2,13
9/13/2023,7,2,2,1,0,0,12
9/14/2023,11,10,4,2,0,3,30
9/15/2023,3,1,2,0,2,2,10
9/16/2023,10,8,3,2,1,1,25
9/17/2023,8,2,5,1,0,1,17
9/18/2023,6,8,2,5,3,4,28
9/19/2023,4,5,2,2,2,1,16
9/20/2023,13,6,6,2,2,1,30
9/21/2023,7,4,2,1,1,1,16
9/22/2023,7,3,3,3,1,1,18
9/23/2023,2,3,2,2,3,1,13
9/24/2023,3,2,3,2,0,1,11
9/25/2023,5,4,1,3,2,1,16
9/26/2023,4,0,0,0,1,1,6
9/27/2023,4,2,2,1,1,2,12
9/28/2023,9,6,4,2,4,3,28
9/29/2023,9,7,0,5,1,2,24
9/30/2023,10,4,2,3,0,3,22
10/1/2023,7,7,3,4,3,2,26
10/2/2023,8,5,2,4,2,3,24
10/3/2023,3,1,2,2,1,1,10
10/4/2023,5,1,3,2,1,2,14
10/5/2023,15,6,2,2,2,4,31
10/6/2023,7,4,3,2,1,4,21
10/7/2023,4,5,1,1,2,3,16
10/8/2023,8,3,3,0,3,1,18
10/9/2023,6,2,4,2,1,0,15
10/10/2023,1,1,2,0,0,0,4
10/11/2023,4,2,3,0,0,1,10
10/12/2023,7,4,5,1,0,3,20
10/13/2023,6,2,3,1,0,2,14
10/14/2023,4,2,5,0,2,1,14
10/15/2023,7,4,2,2,2,2,19
10/16/2023,7,5,3,5,1,0,21
10/17/2023,4,3,5,1,1,2,16
10/18/2023,7,2,3,2,0,3,17
10/19/2023,8,5,3,1,1,3,21
10/20/2023,6,2,4,0,2,0,14
10/21/2023,7,6,0,2,1,1,17
10/22/2023,8,3,6,0,1,2,20
10/23/2023,6,7,0,1,2,1,17
10/24/2023,8,6,2,4,3,1,24
10/25/2023,6,3,1,0,1,2,13
10/26/2023,5,4,3,2,1,0,15
10/27/2023,10,6,1,1,1,2,21
10/28/2023,7,5,2,0,3,1,18
10/29/2023,2,6,1,1,1,1,12
10/30/2023,6,3,3,1,1,1,15
10/31/2023,3,0,0,0,0,0,3
11/1/2023,5,2,2,3,0,3,15
11/2/2023,9,6,4,1,4,1,25
11/3/2023,5,7,2,1,2,2,19
11/4/2023,7,6,3,0,0,1,17
11/5/2023,6,3,2,0,1,3,15
11/6/2023,5,3,0,0,2,1,11
11/7/2023,2,2,2,0,1,2,9
11/8/2023,5,3,4,3,0,2,17
11/9/2023,10,6,4,1,2,3,26
11/10/2023,8,4,4,2,0,3,21
11/11/2023,9,10,4,1,5,3,32
11/12/2023,16,15,4,2,5,1,43
11/13/2023,6,5,1,2,0,1,15
11/14/2023,4,3,3,0,1,0,11
11/15/2023,10,6,2,2,2,3,25
11/16/2023,2,5,0,0,4,3,14
11/17/2023,5,5,1,0,1,0,12
11/18/2023,12,15,1,2,5,1,36
11/19/2023,8,6,1,2,4,1,22
11/20/2023,11,8,3,2,0,2,26
11/21/2023,7,5,1,1,3,0,17
11/22/2023,4,3,3,1,1,2,14
11/23/2023,8,5,3,2,0,5,23
11/24/2023,6,5,1,1,4,2,19
11/25/2023,4,3,0,0,2,0,9
11/26/2023,3,2,1,0,0,2,8
11/27/2023,3,4,0,2,2,2,13
11/28/2023,5,3,3,4,3,2,20
11/29/2023,3,4,2,0,0,2,11
11/30/2023,6,4,1,3,1,4,19
12/1/2023,8,4,1,1,1,2,17
12/2/2023,9,6,0,2,1,3,21
12/3/2023,11,6,4,1,1,2,25
12/4/2023,9,2,2,1,2,3,19
12/5/2023,9,5,3,2,4,2,25
12/6/2023,7,3,5,2,1,3,21
12/7/2023,6,3,0,2,0,1,12
12/8/2023,13,6,2,2,0,2,25
12/9/2023,8,6,4,1,1,4,24
12/10/2023,6,3,1,1,1,0,12
12/11/2023,2,0,1,0,0,1,4
12/12/2023,4,1,0,1,0,1,7
12/13/2023,5,2,0,0,0,0,7
12/14/2023,8,5,1,3,0,1,18
12/15/2023,5,3,0,1,0,1,10
12/16/2023,5,2,2,2,1,1,13
12/17/2023,8,4,1,1,1,0,15
12/18/2023,9,3,2,5,2,2,23
12/19/2023,5,5,1,1,1,0,13
12/20/2023,7,5,2,1,2,2,19
12/21/2023,1,3,1,0,2,1,8
12/22/2023,14,6,1,4,2,2,29
12/23/2023,4,3,2,1,1,3,14
12/24/2023,2,2,2,2,2,1,11
12/25/2023,4,3,5,3,0,2,17
12/26/2023,8,4,1,1,0,4,18
12/27/2023,13,8,2,5,7,3,38
12/28/2023,5,2,2,1,0,1,11
12/29/2023,3,0,2,0,0,2,7
12/30/2023,6,1,1,1,0,3,12
12/31/2023,5,8,2,0,3,2,20
1/1/2024,7,3,2,3,1,3,19
1/2/2024,5,3,3,0,2,2,15
1/3/2024,11,4,5,2,1,3,26
1/4/2024,8,3,1,4,1,1,18
1/5/2024,12,7,2,2,2,3,28
1/6/2024,8,3,5,2,4,1,23
1/7/2024,6,4,2,1,1,1,15
1/8/2024,1,0,0,6,0,0,7
1/9/2024,8,8,6,5,1,3,31
1/10/2024,13,6,6,2,2,2,31
1/11/2024,8,8,5,2,0,3,26
1/12/2024,9,7,5,3,3,1,28
1/13/2024,9,10,3,1,3,1,27
1/14/2024,5,4,2,0,1,3,15
1/15/2024,8,6,4,0,3,0,21
1/16/2024,4,3,6,0,0,4,17
1/17/2024,1,3,1,1,1,0,7
1/18/2024,9,6,4,3,1,0,23
1/19/2024,8,6,5,1,0,1,21
1/20/2024,12,8,1,3,3,2,29
1/21/2024,11,7,4,1,2,3,28
1/22/2024,7,9,3,5,2,1,27
1/23/2024,5,2,4,0,0,4,15
1/24/2024,7,2,3,3,2,4,21
1/25/2024,4,3,1,1,0,2,11
1/26/2024,4,6,2,2,3,0,17
1/27/2024,7,7,3,4,3,2,26
1/28/2024,7,3,5,3,0,2,20
1/29/2024,3,6,3,4,0,2,18
1/30/2024,7,5,2,1,1,4,20
1/31/2024,8,6,1,2,2,0,19
2/1/2024,4,2,0,0,1,0,7
2/2/2024,6,3,5,3,1,4,22
2/3/2024,5,2,5,4,1,2,19
2/4/2024,5,1,2,2,1,2,13
2/5/2024,6,2,4,0,2,3,17
2/6/2024,7,6,1,0,2,2,18
2/7/2024,4,5,4,2,1,2,18
2/8/2024,10,9,1,4,1,5,30
2/9/2024,13,3,2,2,0,4,24
2/10/2024,6,4,1,4,0,2,17
2/11/2024,6,4,1,2,1,0,14
2/12/2024,8,8,2,4,1,1,24
2/13/2024,4,4,1,1,1,1,12
2/14/2024,9,4,3,5,1,3,25
2/15/2024,8,6,4,3,4,3,28
2/16/2024,9,6,5,2,0,5,27
2/17/2024,6,0,1,2,1,2,12
2/18/2024,4,4,1,1,1,3,14
2/19/2024,13,4,3,3,1,4,28
2/20/2024,9,8,7,3,4,1,32
2/21/2024,7,6,5,1,1,3,23
2/22/2024,12,10,6,0,2,8,38
2/23/2024,11,11,5,2,5,1,35
2/24/2024,6,5,3,2,2,2,20
2/25/2024,10,3,0,1,0,4,18
2/26/2024,9,7,4,2,1,3,26
2/27/2024,6,5,1,3,2,1,18
2/28/2024,2,1,3,3,0,2,11
3/1/2024,5,4,2,3,5,2,21
3/2/2024,13,7,1,2,1,5,29
3/3/2024,8,6,2,1,3,2,22
3/4/2024,2,3,1,1,1,3,11
3/5/2024,4,2,4,0,0,2,12
3/6/2024,6,4,5,1,0,1,17
3/7/2024,3,0,5,1,0,1,10
3/8/2024,5,8,1,2,1,4,21
3/9/2024,4,2,0,1,1,0,8
3/10/2024,8,7,2,2,2,1,22
3/11/2024,5,2,2,2,0,2,13
3/12/2024,11,4,2,4,1,5,27
3/13/2024,6,2,2,2,1,2,15
3/14/2024,12,9,3,1,5,2,32
3/15/2024,2,4,0,3,2,1,12
3/16/2024,7,4,1,1,1,3,17
3/17/2024,9,9,4,2,2,3,29
3/18/2024,9,3,0,1,1,1,15
3/19/2024,4,3,1,0,2,2,12
3/20/2024,1,2,3,2,0,0,8
3/21/2024,5,4,5,1,3,1,19
3/22/2024,5,4,1,2,2,1,15
3/23/2024,12,5,7,1,1,8,34
3/24/2024,13,8,2,2,4,3,32
3/25/2024,12,12,1,1,1,3,30
3/26/2024,16,7,2,3,5,4,37
3/27/2024,6,3,1,2,1,0,13
3/28/2024,3,3,5,4,1,1,17
3/29/2024,10,4,2,2,2,4,24
3/30/2024,14,13,5,5,4,3,44
3/31/2024,11,9,3,4,2,1,30
4/1/2024,10,6,6,1,2,5,30
4/2/2024,3,7,3,2,3,1,19
4/3/2024,4,2,5,3,0,0,14
4/4/2024,3,0,1,2,2,0,8
4/5/2024,4,4,4,2,3,2,19
4/6/2024,10,6,2,3,4,2,27
4/7/2024,10,6,6,4,2,2,30
4/8/2024,9,5,5,4,0,3,26
4/9/2024,8,3,2,1,5,5,24
4/10/2024,4,4,3,2,3,2,18
4/11/2024,6,1,2,1,2,3,15
4/12/2024,7,3,3,1,0,0,14
4/13/2024,16,4,5,2,2,5,34
4/14/2024,9,3,5,2,3,3,25
4/15/2024,5,4,2,2,1,3,17
4/16/2024,8,6,2,2,3,1,22
4/17/2024,12,8,9,2,3,2,36
4/18/2024,9,4,0,3,3,1,20
4/19/2024,13,7,3,2,2,4,31
4/20/2024,14,9,3,1,3,3,33
4/21/2024,10,8,3,1,1,3,26
4/22/2024,6,6,5,3,2,5,27
4/23/2024,8,8,6,2,3,5,32
4/24/2024,9,9,1,5,4,2,30
4/25/2024,10,6,0,1,3,2,22
4/26/2024,10,10,0,7,1,3,31
4/27/2024,14,8,3,4,4,1,34
4/28/2024,5,3,2,1,1,1,13
4/29/2024,10,2,4,3,1,2,22
4/30/2024,6,5,2,2,3,1,19
5/1/2024,11,6,4,5,3,2,31
5/2/2024,2,2,2,2,0,1,9
5/3/2024,7,2,3,2,4,2,20
5/4/2024,14,8,1,5,4,2,34
5/5/2024,6,9,4,3,0,3,25
5/6/2024,6,6,1,3,2,1,19
5/7/2024,4,7,4,2,2,2,21
5/8/2024,6,6,4,2,1,6,25
5/9/2024,8,4,1,6,2,0,21
5/10/2024,9,8,3,5,3,2,30
5/11/2024,8,5,2,1,0,3,19
5/12/2024,9,2,2,0,1,3,17
5/13/2024,6,2,4,1,2,1,16
5/14/2024,4,1,2,0,1,1,9
5/15/2024,8,4,4,1,2,3,22
5/16/2024,10,10,4,2,4,4,34
5/17/2024,4,3,3,2,1,2,15
5/18/2024,11,8,4,1,3,4,31
5/19/2024,11,9,4,4,4,3,35
5/20/2024,11,8,2,6,2,3,32
5/21/2024,9,8,3,2,2,2,26
5/22/2024,3,5,1,2,2,1,14
5/23/2024,7,4,2,3,1,1,18
5/24/2024,8,6,2,3,0,2,21
5/25/2024,8,7,2,2,3,1,23
5/26/2024,11,4,3,2,3,6,29
5/27/2024,6,7,4,1,1,3,22
5/28/2024,13,3,4,1,1,5,27
5/29/2024,9,9,2,3,6,0,29
5/30/2024,3,2,0,2,4,3,14
5/31/2024,13,9,9,0,2,3,36
6/1/2024,4,4,3,6,1,0,18
6/2/2024,14,10,6,2,3,3,38
6/3/2024,7,7,5,1,3,1,24
6/4/2024,8,6,3,3,2,1,23
6/5/2024,11,4,5,0,1,3,24
6/6/2024,12,5,3,3,3,1,27
6/7/2024,2,4,3,1,2,1,13
6/8/2024,6,4,1,2,0,3,16
6/9/2024,7,4,0,1,0,1,13
6/10/2024,5,5,2,2,2,3,19
6/11/2024,10,4,1,1,3,2,21
6/12/2024,9,4,6,2,2,3,26
6/13/2024,5,2,2,3,1,1,14
6/14/2024,14,7,3,3,3,0,30
6/15/2024,10,5,4,1,2,4,26
6/16/2024,12,5,2,1,3,2,25
6/17/2024,10,7,3,2,2,1,25
6/18/2024,4,5,2,1,3,0,15
6/19/2024,6,5,4,2,1,1,19
6/20/2024,4,3,3,1,2,4,17
6/21/2024,10,4,2,1,2,0,19
6/22/2024,5,4,2,2,0,1,14
6/23/2024,3,3,2,0,1,0,9
6/24/2024,5,6,5,3,2,4,25
6/25/2024,15,9,5,3,5,3,40
6/26/2024,7,7,4,3,3,0,24
6/27/2024,7,5,2,2,2,3,21
6/28/2024,8,6,4,0,3,3,24
6/29/2024,11,5,4,1,2,3,26
6/30/2024,9,4,4,3,2,3,25
7/1/2024,7,6,1,2,2,2,20
7/2/2024,7,6,3,3,2,3,24
7/3/2024,7,5,4,1,1,3,21
7/4/2024,8,5,4,4,2,3,26
7/5/2024,10,9,6,3,2,3,33
7/6/2024,9,5,0,3,4,1,22
7/7/2024,4,3,1,2,1,3,14
7/8/2024,5,13,6,3,0,3,30
7/9/2024,7,3,2,4,3,2,21
7/10/2024,9,6,6,3,1,2,27
7/11/2024,9,5,1,2,2,4,23
7/12/2024,4,4,5,2,3,2,20
7/13/2024,9,8,2,2,1,4,26
7/14/2024,13,9,3,0,5,2,32
7/15/2024,7,7,4,4,3,1,26
7/16/2024,9,5,4,1,1,1,21
7/17/2024,2,1,2,0,0,2,7
7/18/2024,5,1,0,1,0,2,9
7/19/2024,12,6,5,2,2,4,31
7/20/2024,12,8,5,4,6,3,38
7/21/2024,9,8,2,4,1,0,24
7/22/2024,15,5,4,2,3,1,30
7/23/2024,4,4,5,3,1,3,20
7/24/2024,5,2,0,2,0,1,10
7/25/2024,3,4,5,2,1,1,16
7/26/2024,11,6,4,2,5,2,30
7/27/2024,4,5,5,2,1,2,19
7/28/2024,15,13,3,3,8,3,45
7/29/2024,7,7,4,4,2,2,26
7/30/2024,4,4,1,1,3,1,14
7/31/2024,9,7,4,2,2,2,26
8/1/2024,3,2,3,2,0,0,10
8/2/2024,7,6,2,4,2,2,23
8/3/2024,13,4,2,4,4,2,29
8/4/2024,9,5,1,3,2,4,24
8/5/2024,7,4,6,8,3,0,28
8/6/2024,9,6,5,1,3,1,25
8/7/2024,11,1,3,2,2,2,21
8/8/2024,10,4,2,1,3,0,20
8/9/2024,8,7,1,0,6,1,23
8/10/2024,8,2,1,3,2,4,20
8/11/2024,3,2,1,0,3,2,11
8/12/2024,9,8,2,3,4,2,28
8/13/2024,8,5,2,4,0,1,20
8/14/2024,6,3,3,1,2,3,18
8/15/2024,7,6,3,1,1,5,23
8/16/2024,14,7,5,4,1,7,38
8/17/2024,11,6,1,4,0,1,23
8/18/2024,10,8,4,3,5,5,35
8/19/2024,7,8,6,3,4,2,30
8/20/2024,6,4,1,3,1,4,19
8/21/2024,7,9,3,2,2,4,27
8/22/2024,6,6,6,0,4,1,23
8/23/2024,7,4,1,1,0,1,14
8/24/2024,10,3,2,1,3,0,19
8/25/2024,8,2,2,1,4,1,18
8/26/2024,3,3,1,0,1,3,11
8/27/2024,13,5,2,4,2,1,27
8/28/2024,10,6,4,5,5,3,33
8/29/2024,3,4,1,1,1,3,13
8/30/2024,13,6,5,1,3,6,34
8/31/2024,5,1,1,7,3,3,20
9/1/2024,6,4,1,3,3,2,19
9/2/2024,12,2,3,1,5,4,27
9/3/2024,9,9,5,2,3,1,29
9/4/2024,10,7,5,3,5,2,32
9/5/2024,5,3,2,1,0,0,11
9/6/2024,12,7,6,1,4,1,31
9/7/2024,11,6,5,1,5,4,32
9/8/2024,10,7,6,0,5,5,33
9/9/2024,3,1,4,0,0,1,9
9/10/2024,10,6,4,1,6,2,29
9/11/2024,5,5,6,1,2,0,19
9/12/2024,4,3,3,1,1,0,12
9/13/2024,7,4,1,2,4,1,19
9/14/2024,15,6,2,3,2,2,30
9/15/2024,5,2,0,2,2,0,11
9/16/2024,6,3,2,1,1,3,16
9/17/2024,8,1,4,3,3,3,22
9/18/2024,5,7,6,1,3,1,23
9/19/2024,10,4,4,3,1,1,23
9/20/2024,14,7,2,5,3,2,33
9/21/2024,4,2,2,1,3,1,13
9/22/2024,9,9,7,1,7,2,35
9/23/2024,6,3,5,1,2,5,22
9/24/2024,11,4,3,3,3,3,27
9/25/2024,6,3,5,1,0,5,20
9/26/2024,6,1,2,0,1,1,11
9/27/2024,16,9,3,1,3,5,37
9/28/2024,7,7,4,3,3,1,25
9/29/2024,11,7,2,2,4,3,29
9/30/2024,6,3,2,3,1,3,18
10/1/2024,7,4,3,1,0,5,20
10/2/2024,7,3,10,0,2,2,24
10/3/2024,10,6,3,3,7,0,29
10/4/2024,10,8,2,3,4,1,28
10/5/2024,8,4,2,1,2,0,17
10/6/2024,12,4,3,2,5,1,27
10/7/2024,5,4,4,1,1,2,17
10/8/2024,6,4,2,2,4,0,18
10/9/2024,3,5,2,4,0,2,16
10/10/2024,10,6,5,3,4,2,30
10/11/2024,18,8,1,2,5,6,40
10/12/2024,12,9,4,3,2,2,32
10/13/2024,3,5,8,4,4,0,24
10/14/2024,10,6,8,2,6,1,33
10/15/2024,4,4,4,0,1,1,14
10/16/2024,13,8,8,2,3,3,37
10/17/2024,3,4,2,0,1,1,11
10/18/2024,9,6,5,1,2,3,26
10/19/2024,8,3,2,6,2,2,23
10/20/2024,6,4,8,3,2,4,27
10/21/2024,7,8,4,8,6,3,36
10/22/2024,8,3,6,3,2,3,25
10/23/2024,0,0,0,4,0,0,4
10/24/2024,2,1,5,0,3,1,12
10/25/2024,5,5,1,1,1,3,16
10/26/2024,14,12,3,0,2,3,34
10/27/2024,12,8,0,3,8,5,36
10/28/2024,9,6,5,1,2,3,26
10/29/2024,13,11,4,3,3,5,39
10/30/2024,10,9,3,2,7,4,35
10/31/2024,6,5,3,3,4,1,22
11/1/2024,11,5,2,0,4,4,26
11/2/2024,7,6,3,2,1,3,22
11/3/2024,6,3,6,0,0,3,18
11/4/2024,7,3,2,1,2,1,16
11/5/2024,8,1,3,1,0,3,16
11/6/2024,3,1,1,1,1,0,7
11/7/2024,7,0,4,1,1,1,14
11/8/2024,8,6,1,2,5,2,24
11/9/2024,12,8,2,5,2,4,33
11/10/2024,10,4,0,2,1,1,18
11/11/2024,19,14,2,7,6,6,54
11/12/2024,11,3,2,1,1,3,21
11/13/2024,9,4,2,1,2,4,22
11/14/2024,6,4,0,2,1,1,14
11/15/2024,5,5,5,3,2,3,23
11/16/2024,4,3,2,1,0,0,10
11/17/2024,8,3,1,0,2,0,14
11/18/2024,14,16,2,3,2,3,40
11/19/2024,3,1,1,3,1,1,10
11/20/2024,5,1,1,2,3,2,14
11/21/2024,7,0,2,1,5,4,19
11/22/2024,11,7,5,5,4,1,33
11/23/2024,11,2,1,2,3,2,21
11/24/2024,6,5,6,1,3,3,24
11/25/2024,6,1,5,2,1,2,17
11/26/2024,7,10,2,4,2,3,28
11/27/2024,7,3,1,1,3,3,18
11/28/2024,8,1,1,3,1,3,17
11/29/2024,8,1,4,1,1,1,16
11/30/2024,11,5,8,1,3,1,29
12/1/2024,7,8,1,1,4,2,23
12/2/2024,8,1,3,4,2,3,21
12/3/2024,5,4,2,4,0,0,15
12/4/2024,6,5,5,0,0,2,18
12/5/2024,11,3,2,2,2,1,21
12/6/2024,11,5,3,1,1,4,25
12/7/2024,1,2,2,1,2,1,9
12/8/2024,10,3,2,2,1,3,21
12/9/2024,5,3,3,1,4,3,19
12/10/2024,7,5,3,1,1,1,18
12/11/2024,1,0,2,1,1,0,5
12/12/2024,10,3,3,0,1,1,18
12/13/2024,11,2,1,3,1,5,23
12/14/2024,5,3,1,0,1,1,11
12/15/2024,7,8,4,1,3,1,24
12/16/2024,5,4,1,4,2,0,16
12/17/2024,17,11,5,1,2,2,38
12/18/2024,4,3,1,2,2,1,13
12/19/2024,8,6,4,1,2,2,23
12/20/2024,11,9,1,2,1,3,27
12/21/2024,12,9,3,4,3,3,34
12/22/2024,6,3,5,1,5,5,25
12/23/2024,11,10,2,5,9,2,39
12/24/2024,9,4,2,3,0,1,19
12/25/2024,8,5,3,1,2,1,20
12/26/2024,8,5,1,1,2,0,17
12/27/2024,15,8,3,5,2,2,35
12/28/2024,11,11,7,1,7,1,38
12/29/2024,3,5,2,0,3,2,15
12/30/2024,10,5,2,0,5,0,22
12/31/2024,7,7,0,1,3,1,19
